Namespace,Type,CyclomaticComplexity,DepthOfInheritance,ClassCoupling,LinesOfCode,NumberOfMethods,Toxicity
System.Web.Mvc,HtmlHelper,5,0,3,6,5,19
Microsoft.Web.Mvc.ExpressionUtil,FingerprintingExpressionVisitor,3,0,3,5,4,15
Microsoft.Web.Mvc.ModelBinding,MutableObjectModelBinder,4,0,3,5,3,15
System.Collections.Generic,CollectionExtensions,4,0,0,6,4,14
System.Net.Http,HttpRequestMessageExtensions,5,0,0,5,4,14
System.Web.Http.Metadata,ModelMetadata,5,0,0,5,4,14
System.Web.Http.Metadata.Providers,CachedModelMetadata<TPrototypeCache>,4,0,0,5,4,13
System.Web.Razor.Parser,CSharpCodeParser,0,0,3,6,4,13
Microsoft.Web.Mvc,Error,3,0,0,5,5,13
System.Web.Razor.Parser,VBCodeParser,0,0,3,6,4,13
System.Net.Http.Internal,AsyncResult,4,0,0,5,3,12
System.Web.Http.Validation.Providers,DataAnnotationsModelValidatorProvider,4,0,0,5,3,12
System.Web.Http.ModelBinding,ModelStateDictionary,4,0,0,4,4,12
WebMatrix.WebData,SimpleMembershipProvider,0,1,4,3,4,12
System.Web.Razor.Parser,HtmlMarkupParser,0,0,3,5,3,11
System.Web.Http.Routing,HttpParsedRoute,4,0,2,5,0,11
Microsoft.Web.Mvc.ModelBinding,ModelValidationNode,4,0,0,4,3,11
System.Web.Http,NonOwnedStream,3,0,0,4,4,11
System.Web.Http.Description,ApiExplorer,0,0,4,3,3,10
System.Web.Http.Metadata.Providers,CachedDataAnnotationsModelMetadata,4,0,0,4,2,10
System.Web.Mvc,DefaultModelBinder,0,0,4,3,3,10
System.Web.Http.Routing,DirectRouteBuilder,3,0,0,4,3,10
System.Web.Http.Routing,RouteParser,4,0,0,5,1,10
System.Web.Http.Routing,UrlHelper,3,0,0,4,3,10
System.Web.Http.Routing,AttributeRoutingMapper,3,0,2,4,0,9
System.Web.Http,AuthorizeAttribute,3,1,0,3,2,9
System.Web.Mvc,BuildManagerWrapper,3,0,0,4,2,9
System.Web.Mvc,Controller,0,0,4,0,5,9
Microsoft.Web.Mvc,FormExtensions,2,0,0,4,3,9
Microsoft.Web.Helpers,PreApplicationStartCode,3,0,0,4,2,9
System.Web.Mvc.Html,ValidationExtensions,0,0,3,3,3,9
System.Web.Http.ValueProviders,ValueProviderResult,3,0,0,4,2,9
System.Web.Mvc,ControllerActionInvoker,0,0,4,2,2,8
System.Web.Http.SelfHost,HttpSelfHostServer,0,1,4,0,3,8
System.Net.Http.Formatting.Parsers,MimeMultipartParser,3,0,0,5,0,8
ROOT_PROJECT_NAMESPACE.Areas.HelpPage.ModelDescriptions,ModelDescriptionGenerator,0,0,4,4,0,8
Microsoft.Web.Mvc.Resources,RouteCollectionExtensions,3,0,0,4,1,8
System.Web.Http,UriQueryUtility,4,0,0,4,0,8
System.Web.Http,ApiController,0,0,4,0,3,7
System.Web.Mvc.Async,AsyncControllerActionInvoker,1,0,3,3,0,7
System.Web.Http.Metadata.Providers,CachedDataAnnotationsMetadataAttributes,2,0,0,2,3,7
System.Web.Http.Routing,DefaultDirectRouteProvider,3,0,0,4,0,7
Microsoft.AspNet.Facebook.Authorization,FacebookAuthorizeFilter,1,0,2,4,0,7
System.Net.Http.Formatting.Parsers,HttpRequestLineParser,3,0,0,4,0,7
System.Net.Http.Formatting.Parsers,HttpStatusLineParser,3,0,0,4,0,7
Microsoft.Web.Mvc,LinkExtensions,2,0,0,3,2,7
System.Web.Http.ModelBinding,ModelBindingContext,2,0,0,2,3,7
System.Web.Mvc,OutputCacheAttribute,0,1,3,0,3,7
System.Web.Razor.Parser,"TokenizerBackedParser<TTokenizer, TSymbol, TSymbolType>",0,0,3,0,4,7
System.Web.Http.Tracing,TraceWriterExceptionMapper,3,0,0,4,0,7
System.Web.Mvc,VirtualPathProviderViewEngine,0,0,2,2,3,7
System.Web.Helpers,WebGrid,0,0,3,0,4,7
System.Web.Helpers,Chart,0,0,3,0,3,6
System.Web.Razor.Generator,CodeGeneratorContext,0,0,3,0,3,6
System.Web.Razor.Tokenizer,CSharpTokenizer,1,0,0,3,2,6
System.Web.Http.Metadata.Providers,DataAnnotationsModelMetadataProvider,2,0,0,4,0,6
System.Web.Mvc.Html,DefaultEditorTemplates,0,0,3,1,2,6
System.Web.Http.Services,DefaultServices,0,0,4,2,0,6
System.Web.Http.Routing,DirectRouteFactoryContext,2,0,0,3,1,6
System.Web.Http.Filters,FilterInfo,3,0,0,3,0,6
System.Web.Http.WebHost,HttpControllerHandler,0,0,4,1,1,6
System.Web.Http.Owin,HttpMessageHandlerAdapter,0,0,4,0,2,6
System.Web.Mvc.Html,InputExtensions,0,0,0,3,3,6
System.Net.Http.Formatting.Parsers,InternetMessageFormatHeaderParser,2,0,0,4,0,6
System.Web.Helpers,ObjectVisitor,0,0,2,2,2,6
System.Web,PrefixContainer,2,0,0,4,0,6
System.Web.Http.Internal,PropertyHelper,0,0,0,4,2,6
System.Web.Mvc.Html,SelectExtensions,0,0,3,0,3,6
System.Web.Mvc.Async,TaskAsyncActionDescriptor,0,0,3,3,0,6
Microsoft.Web.Mvc,TypeHelpers,2,0,0,4,0,6
System.Web.Helpers,WebImage,0,0,3,0,3,6
System.Web.WebPages,WebPageBase,0,0,3,0,3,6
System.Web.WebPages.Razor,WebPageRazorHost,0,0,3,0,3,6
System.Web.Http.Controllers,ApiControllerActionSelector.ActionSelectorCacheItem,0,0,3,0,2,5
Microsoft.Web.Mvc.ExpressionUtil,"CachedExpressionCompiler.Compiler<TIn, TOut>",2,0,0,3,0,5
System.Net.Http.Headers,CookieHeaderValue,0,0,0,3,2,5
WebMatrix.Data,Database,0,0,3,0,2,5
System.Net.Http,FormattingUtilities,2,0,0,3,0,5
ROOT_PROJECT_NAMESPACE.Areas.HelpPage,HelpPageConfigurationExtensions,0,0,3,0,2,5
ROOT_PROJECT_NAMESPACE.Areas.HelpPage,HelpPageSampleGenerator,0,0,3,1,1,5
System.Web.Http.SelfHost.Channels,HttpMessageEncodingRequestContext,0,0,2,2,1,5
System.Web.Http.Tracing.Tracers,MediaTypeFormatterTracer,0,0,3,0,2,5
System.Web.WebPages.Razor,RazorBuildProvider,0,0,2,0,3,5
System.Web.Mvc.Async,ReflectedAsyncActionDescriptor,0,0,3,2,0,5
System.Web.Razor.Tokenizer,VBTokenizer,1,0,0,3,1,5
Microsoft.Web.Mvc.Resources,WebApiEnabledAttribute,0,1,2,2,0,5
System.Web.WebPages,WebPageExecutingBase,0,0,0,2,3,5
System.Web.WebPages.Deployment,WebPagesDeployment,0,0,3,0,2,5
System.Web.WebPages.Administration.PackageManager,WebProjectManager,0,0,3,0,2,5
System.Net.Http.Formatting,XmlMediaTypeFormatter,0,0,2,0,3,5
System.Web.WebPages,ApplicationStartPage,0,0,2,0,2,4
Microsoft.Web.Mvc.ModelBinding,CollectionModelBinderUtil,1,0,0,3,0,4
System.Net.Http.Formatting,DefaultContentNegotiator,0,0,1,3,0,4
System.Web.Mvc,DefaultControllerFactory,0,0,3,0,1,4
System.Web.Http.Routing,DefaultInlineConstraintResolver,0,0,1,3,0,4
Microsoft.Web.Mvc.Controls,DropDownList,1,0,0,3,0,4
Microsoft.Web.Mvc.Html,HtmlHelperExtensions,0,0,0,0,4,4
System.Web.Http.Controllers,HttpActionDescriptor,0,0,2,0,2,4
System.Web.Http,HttpConfiguration,0,0,2,0,2,4
System.Net.Http.Formatting,MediaTypeFormatter,0,0,1,0,3,4
Microsoft.Web.WebPages.OAuth,OAuthWebSecurity,0,0,1,0,3,4
System.Web.Razor.Parser,ParserContext,0,0,1,0,3,4
System.Web.Razor.Tokenizer,"Tokenizer<TSymbol, TSymbolType>",0,0,1,0,3,4
System.Web.WebPages,ValidationHelper,0,0,2,0,2,4
System.Web.Mvc,ViewTemplateUserControl,0,4,0,0,0,4
System.Web.Helpers,WebMail,0,0,1,2,1,4
WebMatrix.WebData,WebSecurity,0,0,1,0,3,4
System.Web.Mvc.Ajax,AjaxExtensions,0,0,0,0,3,3
System.Web.Mvc.Ajax,AjaxOptions,0,0,0,0,3,3
System.Web.Mvc.Async,AsyncControllerActionInvoker.AsyncInvocationWithFilters,0,0,0,3,0,3
System.Web.Razor.Editor,BackgroundParser.BackgroundThread,0,0,0,3,0,3
System.Net.Http,ByteRangeStreamContent,0,0,0,3,0,3
System.Web.Razor.Generator,CodeWriter,0,0,0,0,3,3
Microsoft.Web.Mvc.ModelBinding,CollectionModelBinder<TElement>,0,0,0,3,0,3
Microsoft.Web.Mvc,DynamicViewPage<TModel>,0,3,0,0,0,3
Microsoft.Web.Mvc.Internal,ExpressionHelper,0,0,0,3,0,3
System.Web.Http.ModelBinding,FormDataCollectionExtensions,0,0,2,1,0,3
System.Net.Http.Formatting.Parsers,FormUrlEncodedParser,0,0,0,3,0,3
System.Web.Razor.Generator,GeneratedClassContext,0,0,0,0,3,3
System.Web.WebPages,HelperPage,0,0,0,0,3,3
System.Web.Http.WebHost.Routing,HostedHttpRouteCollection,0,0,2,0,1,3
System.Web.Helpers,HtmlObjectPrinter,0,0,0,0,3,3
System.Net.Http,HttpClientExtensions,0,0,0,0,3,3
System.Net.Http,HttpContentMessageExtensions,0,0,2,0,1,3
System.Web.Http.SelfHost.Channels,HttpMessageEncodingChannelListener,0,3,0,0,0,3
System.Web.Http.Routing,HttpRoute,0,0,1,0,2,3
System.Web.Http,HttpRouteCollection,0,0,1,0,2,3
System.Web.Http.Routing,IDirectRouteBuilder,0,0,0,0,3,3
System.Web.Mvc,MultiSelectList,0,0,0,0,3,3
System.Web.Mvc,MvcHandler,0,0,2,0,1,3
ROOT_PROJECT_NAMESPACE.Areas.HelpPage,ObjectGenerator.SimpleTypeObjectGenerator,3,0,0,0,0,3
System.Web.Razor,RazorEngineHost,0,0,0,0,3,3
System.Web.Http.Controllers,ReflectedHttpActionDescriptor,0,0,2,0,1,3
System.Web.Http.Controllers,ReflectedHttpActionDescriptor.ActionExecutor,0,0,0,3,0,3
System.Web.Razor.Generator,ResolveUrlCodeGenerator,0,0,0,3,0,3
System.Web.Http.Routing,RouteFactoryAttribute,0,0,0,3,0,3
WebMatrix.WebData,SimpleRoleProvider,0,0,0,0,3,3
System.Threading.Tasks,TaskHelpers,0,0,0,0,3,3
System.Web.Mvc.Html,TemplateHelpers,0,0,3,0,0,3
Microsoft.Web.Helpers,Video,0,0,1,2,0,3
System.Web.Mvc,ViewContext,0,0,0,0,3,3
System.Web.Mvc,ViewDataDictionary,0,0,0,0,3,3
System.Web.Mvc,ViewMasterPage<TModel>,0,3,0,0,0,3
System.Web.Mvc,ViewMasterPageControlBuilder,0,3,0,0,0,3
System.Web.Mvc,ViewPage,0,1,0,0,2,3
System.Web.Mvc,ViewPage.SwitchWriter,0,0,0,0,3,3
System.Web.Mvc,ViewTemplateUserControl<TModel>,0,3,0,0,0,3
System.Net.Http.Formatting,BsonMediaTypeFormatter,0,0,2,0,0,2
System.Web.Http.SelfHost.ServiceModel.Channels,BufferedOutputStream,0,0,0,0,2,2
System.Web.Mvc.Html,ChildActionExtensions,0,0,2,0,0,2
System.Web.Mvc.Html,DefaultDisplayTemplates,0,0,2,0,0,2
System.Web.Http.Batch,DefaultHttpBatchHandler,0,0,2,0,0,2
System.Web.Http.Dispatcher,DefaultHttpControllerSelector,0,0,2,0,0,2
System.Net.Http.Internal,DelegatingStream,0,0,0,0,2,2
System.Web.Mvc.Routing,DirectRouteCandidate,0,0,1,0,1,2
Microsoft.Web.Mvc,DynamicViewPage,0,2,0,0,0,2
System.Web.Http.ExceptionHandling,ExceptionContext,0,0,0,0,2,2
WebMatrix.WebData,ExtendedMembershipProvider,0,0,0,0,2,2
Microsoft.AspNet.Facebook.ModelBinders,FacebookContextModelBinder,0,0,0,2,0,2
System.Web.Http.Tracing.Tracers,FilterTracer,0,0,0,2,0,2
Microsoft.Web.Mvc.ExpressionUtil,HashCodeCombiner,0,0,0,0,2,2
System.Web.Http.Tracing.Tracers,HttpActionDescriptorTracer,0,0,2,0,0,2
System.Web.Mvc,HttpAntiForgeryException,0,2,0,0,0,2
System.Web.Mvc,HttpHandlerUtil.ServerExecuteHttpHandlerAsyncWrapper,0,2,0,0,0,2
System.Net.Http,HttpMessageContent,0,0,2,0,0,2
System.Web.Http.SelfHost,HttpSelfHostConfiguration,0,0,0,0,2,2
System.Web.Razor.Editor,ImplicitExpressionEditHandler,0,0,0,0,2,2
System.Web.Http.Routing,InlineRouteTemplateParser,0,0,0,2,0,2
System.Net.Http.Formatting,JsonMediaTypeFormatter,0,0,2,0,0,2
System.Web.Http.SelfHost.ServiceModel.Channels,LayeredChannelListener<TChannel>,0,2,0,0,0,2
System.Web.Razor.Generator,LiteralAttributeCodeGenerator,0,0,0,2,0,2
Microsoft.Web.Mvc.ModelBinding,ModelBinderConfig,0,0,0,0,2,2
Microsoft.Web.Mvc.ModelBinding,ModelBinderProviderCollection,0,0,0,0,2,2
System.Web.Mvc,NoAsyncTimeoutAttribute,0,2,0,0,0,2
ROOT_PROJECT_NAMESPACE.Areas.HelpPage,ObjectGenerator,0,0,2,0,0,2
System.Web.WebPages,PageDataDictionary<TValue>,0,0,0,0,2,2
System.Web.Razor.Parser,RazorParser,0,0,2,0,0,2
System.Web.WebPages.Scope,ScopeStorageDictionary,0,0,0,0,2,2
System.Web.Helpers,ServerInfo,0,0,2,0,0,2
System.Web.Http,ServicesExtensions,0,0,0,0,2,2
System.Web.Razor.Parser.SyntaxTree,Span,0,0,0,0,2,2
System.Web.Razor.Editor,SpanEditHandler,0,0,0,0,2,2
System.Web.Mvc.Async,SynchronousOperationException,0,2,0,0,0,2
System.Threading.Tasks,TaskHelpersExtensions,0,0,0,0,2,2
System.Web.Razor.Text,TextChange,0,0,0,0,2,2
System.Web.Mvc,ValueProviderDictionary,0,0,0,0,2,2
System.Web.Mvc,ViewMasterPage,0,2,0,0,0,2
System.Web.Mvc,ViewPage<TModel>,0,2,0,0,0,2
System.Web.Mvc,ViewPageControlBuilder,0,2,0,0,0,2
System.Web.Mvc,ViewUserControl.ViewUserControlContainerPage,0,2,0,0,0,2
System.Web.Mvc,ViewUserControl<TModel>,0,2,0,0,0,2
System.Web.Mvc,ViewUserControlControlBuilder,0,2,0,0,0,2
System.Web.WebPages,WebPageHttpHandler,0,0,2,0,0,2
System.Web.WebPages,WebPageRenderingBase,0,0,0,0,2,2
System.Web.Mvc,WebViewPage,0,1,0,0,1,2
System.Web.Mvc,WebViewPage<TModel>,0,2,0,0,0,2
Microsoft.Web.Mvc,AcceptAttribute,0,1,0,0,0,1
System.Web.Http.Tracing.Tracers,ActionFilterAttributeTracer,0,1,0,0,0,1
System.Web.Mvc,ActionMethodSelectorBase,0,0,0,0,1,1
System.Web.Http.Metadata.Providers,AssociatedMetadataProvider<TModelMetadata>,0,0,1,0,0,1
Microsoft.Web.Mvc,AsyncManagerExtensions,0,0,0,1,0,1
System.Web.Mvc,AsyncTimeoutAttribute,0,1,0,0,0,1
System.Web.Http.Cors,AttributeBasedPolicyProviderFactory,0,0,1,0,0,1
System.Web.Http.Tracing.Tracers,AuthorizationFilterAttributeTracer,0,1,0,0,0,1
System.Net.Http.Formatting,BaseJsonMediaTypeFormatter,0,0,1,0,0,1
System.Web.Razor.Parser.SyntaxTree,Block,0,0,0,0,1,1
System.Web.Razor.Text,BufferingTextReader,0,1,0,0,0,1
System.Web.Http.SelfHost.ServiceModel.Channels,BufferManagerOutputStream,0,1,0,0,0,1
System.Net.Http.Internal,ByteRangeStream,0,1,0,0,0,1
System.Web.Mvc,CachedDataAnnotationsModelMetadataProvider,0,1,0,0,0,1
System.Web.Mvc,CompareAttributeAdapter,0,1,0,0,0,1
System.Web.Mvc,CompareAttributeAdapter.CompareAttributeWrapper,0,1,0,0,0,1
Microsoft.Web.Mvc,ContentTypeAttribute,0,1,0,0,0,1
Microsoft.Web.Mvc,CopyAsyncParametersAttribute,0,1,0,0,0,1
Microsoft.Web.Mvc,CreditCardAttribute,0,1,0,0,0,1
System.Web.Http.Validation,DefaultBodyModelValidator,0,0,1,0,0,1
System.Collections.Generic,DictionaryExtensions,0,0,0,0,1,1
System.Web.Mvc.Routing,DirectRouteExtensions,0,0,0,0,1,1
System.Web.Razor.Generator,DynamicAttributeBlockCodeGenerator,0,0,0,1,0,1
System.Web.WebPages,DynamicPageDataDictionary<TValue>,0,0,0,0,1,1
WebMatrix.Data,DynamicRecord,0,0,0,0,1,1
Microsoft.Web.Mvc,EmailAddressAttribute,0,1,0,0,0,1
System.Web.Http.Tracing.Tracers,ExceptionFilterAttributeTracer,0,1,0,0,0,1
Microsoft.Web.Mvc,FileExtensionsAttribute,0,1,0,0,0,1
System.Web.Mvc,FileExtensionsAttributeAdapter,0,1,0,0,0,1
System.Web.Http.ModelBinding,FormatterParameterBinding,0,0,1,0,0,1
System.Web.Http.Tracing.Tracers,FormatterParameterBindingTracer,0,0,1,0,0,1
System.Net.Http.Formatting,FormUrlEncodedJson,0,0,0,1,0,1
System.Web.Http,FromUriAttribute,0,1,0,0,0,1
Microsoft.Web.Mvc.Controls,Hidden,0,1,0,0,0,1
System.Web.Http.SelfHost.Channels,HttpBinding,0,0,0,0,1,1
System.Web.Http,HttpConfigurationExtensions,0,0,1,0,0,1
System.Web.Mvc,HttpHandlerUtil.ServerExecuteHttpHandlerWrapper,0,1,0,0,0,1
System.Web.Http.SelfHost.Channels,HttpMessage,0,0,0,0,1,1
System.Web.Http.SelfHost.Channels,HttpMessageEncodingReplyChannel,0,1,0,0,0,1
System.Web.Http.WebHost.Routing,HttpWebRoute,0,0,1,0,0,1
System.Web.Http.Tracing,ITraceWriterExtensions,0,0,0,0,1,1
System.Web.Http.Tracing.Tracers,JsonMediaTypeFormatterTracer,0,1,0,0,0,1
System.Web.Mvc.Html,LabelExtensions,0,0,0,0,1,1
System.Web.Mvc,MaxLengthAttributeAdapter,0,1,0,0,0,1
System.Net.Http.Formatting,MediaTypeFormatterCollection,0,0,0,0,1,1
System.Web.Mvc,MembershipPasswordAttributeAdapter,0,1,0,0,0,1
System.Web.Mvc,MinLengthAttributeAdapter,0,1,0,0,0,1
System.Web.Mvc,ModelBinderDictionary,0,0,0,0,1,1
System.Web.Mvc.Razor,MvcCSharpRazorCodeGenerator,0,1,0,0,0,1
System.Web.Mvc.Razor,MvcCSharpRazorCodeParser,0,1,0,0,0,1
Microsoft.Web.Mvc.Controls,MvcInputControl,0,0,0,1,0,1
System.Web.Mvc.Razor,MvcVBRazorCodeParser,0,1,0,0,0,1
System.Net.Http.Internal,NonClosingDelegatingStream,0,1,0,0,0,1
System.Web.Mvc,OutputCacheAttribute.OutputCachedPage,0,1,0,0,0,1
Microsoft.Web.Mvc.Controls,Password,0,1,0,0,0,1
System.Net.Http.Handlers,ProgressStream,0,1,0,0,0,1
System.Net.Http,PushStreamContent.CompleteTaskOnCloseStream,0,1,0,0,0,1
System.Web.Mvc,RangeAttributeAdapter,0,1,0,0,0,1
System.Web.Http.Results,RedirectToRouteResult,0,0,0,0,1,1
System.Web.Mvc,RegularExpressionAttributeAdapter,0,1,0,0,0,1
System.Web.WebPages.Administration.PackageManager,RemoteAssembly,0,0,0,0,1,1
System.Web.Mvc,RequiredAttributeAdapter,0,1,0,0,0,1
System.Web.Http.Routing,RouteCollectionRoute,0,0,0,0,1,1
System.Web.Http.WebHost,SeekableBufferedRequestStream,0,1,0,0,0,1
System.Web.Http.Controllers,ServicesContainer,0,0,0,0,1,1
Microsoft.AspNet.Facebook,ShowPromptResult,0,1,0,0,0,1
System.Web.WebPages.Administration,SiteAdmin,0,0,0,0,1,1
System.Web.Mvc,StringLengthAttributeAdapter,0,1,0,0,0,1
System.Web.Mvc,TagBuilder,0,0,0,0,1,1
System.Web.Mvc,TempDataDictionary,0,0,0,0,1,1
Microsoft.Web.Mvc.Controls,TextBox,0,1,0,0,0,1
System.Web.Razor.Text,TextBufferReader,0,1,0,0,0,1
System.Web.Http.Tracing,TraceRecord,0,0,0,0,1,1
Microsoft.Web.Mvc,UrlAttribute,0,1,0,0,0,1
System.Web.Http.ValueProviders,ValueProviderAttribute,0,1,0,0,0,1
System.Web.Mvc,ViewStartPage,0,1,0,0,0,1
System.Web.Mvc,ViewUserControl,0,1,0,0,0,1
System.Web.Helpers,WebGridDataSource,0,0,1,0,0,1
System.Web.WebPages,WebPage,0,1,0,0,0,1
System.Web.WebPages,WebPageContext,0,0,0,0,1,1
System.Web.WebPages.Razor,WebRazorHostFactory,0,0,1,0,0,1
System.Web.Razor.Parser.SyntaxTree,AcceptedCharacters,0,0,0,0,0,0
System.Web.Http,AcceptVerbsAttribute,0,0,0,0,0,0
System.Web.Mvc,ActionDescriptor,0,0,0,0,0,0
System.Web.Mvc.Async,ActionDescriptorCreator,0,0,0,0,0,0
System.Web.Http.Filters,ActionDescriptorFilterProvider,0,0,0,0,0,0
System.Web.Mvc,ActionDescriptorHelper,0,0,0,0,0,0
System.Web.Mvc,ActionDescriptorHelper.CreateDescriptorState,0,0,0,0,0,0
System.Web.Mvc,ActionExecutedContext,0,0,0,0,0,0
System.Web.Mvc,ActionExecutingContext,0,0,0,0,0,0
System.Web.Http.Filters,ActionFilterAttribute,0,0,0,0,0,0
System.Web.Http.Controllers,ActionFilterResult,0,0,0,0,0,0
System.Web.Http.Controllers,ActionFilterResult.ActionInvoker,0,0,0,0,0,0
System.Web.Http.Tracing.Tracers,ActionFilterTracer,0,0,0,0,0,0
Microsoft.Web.Mvc.Controls,ActionLink,0,0,0,0,0,0
Microsoft.Web.Mvc,ActionLinkAreaAttribute,0,0,0,0,0,0
System.Web.Mvc,ActionMethodDispatcher,0,0,0,0,0,0
System.Web.Mvc,ActionMethodDispatcher.ActionExecutor,0,0,0,0,0,0
System.Web.Mvc,ActionMethodDispatcher.VoidActionExecutor,0,0,0,0,0,0
System.Web.Mvc,ActionMethodDispatcherCache,0,0,0,0,0,0
System.Web.Mvc,ActionMethodSelector,0,0,0,0,0,0
System.Web.Mvc,ActionMethodSelectorAttribute,0,0,0,0,0,0
System.Web.Mvc,ActionMethodSelectorBase.StandardRouteActionMethodCache,0,0,0,0,0,0
System.Web.Http,ActionNameAttribute,0,0,0,0,0,0
System.Web.Mvc,ActionNameSelector,0,0,0,0,0,0
System.Web.Mvc,ActionNameSelectorAttribute,0,0,0,0,0,0
System.Web.Mvc,ActionResult,0,0,0,0,0,0
System.Web.Mvc,ActionSelector,0,0,0,0,0,0
Microsoft.Web.Mvc.Resources,ActionType,0,0,0,0,0,0
System.Web.Http.Tracing.Tracers,ActionValueBinderTracer,0,0,0,0,0,0
System.Web.Razor.Generator,AddImportCodeGenerator,0,0,0,0,0,0
System.Web.Mvc,AdditionalMetadataAttribute,0,0,0,0,0,0
System.Web.WebPages.Administration,AdminSecurity,0,0,0,0,0,0
System.Web.Mvc,AjaxHelper,0,0,0,0,0,0
System.Web.Mvc,AjaxHelper<TModel>,0,0,0,0,0,0
Microsoft.Web.Mvc.Resources,AjaxHelperExtensions,0,0,0,0,0,0
Microsoft.Web.Mvc,AjaxOnlyAttribute,0,0,0,0,0,0
System.Web.Mvc,AjaxRequestExtensions,0,0,0,0,0,0
System.Web.Http,AllowAnonymousAttribute,0,0,0,0,0,0
System.Web.Mvc,AllowHtmlAttribute,0,0,0,0,0,0
System.Web.Http.Routing.Constraints,AlphaRouteConstraint,0,0,0,0,0,0
System.Web.Helpers,AntiForgery,0,0,0,0,0,0
System.Web.Helpers,AntiForgeryConfig,0,0,0,0,0,0
System.Web.Helpers.AntiXsrf,AntiForgeryConfigWrapper,0,0,0,0,0,0
System.Web.Helpers.AntiXsrf,AntiForgeryToken,0,0,0,0,0,0
System.Web.Helpers.AntiXsrf,AntiForgeryTokenSerializer,0,0,0,0,0,0
System.Web.Helpers.AntiXsrf,AntiForgeryTokenStore,0,0,0,0,0,0
System.Web.Helpers.AntiXsrf,AntiForgeryWorker,0,0,0,0,0,0
System.Web.Http.Controllers,ApiControllerActionInvoker,0,0,0,0,0,0
System.Web.Http.Controllers,ApiControllerActionSelector,0,0,0,0,0,0
System.Web.Http.Controllers,ApiControllerActionSelector.CandidateActionWithParams,0,0,0,0,0,0
System.Web.Http.Controllers,ApiControllerActionSelector.StandardActionSelectionCache,0,0,0,0,0,0
System.Web.Http.Description,ApiDescription,0,0,0,0,0,0
ROOT_PROJECT_NAMESPACE.Areas.HelpPage,ApiDescriptionExtensions,0,0,0,0,0,0
System.Web.Http.Description,ApiExplorer.ApiDescriptionComparer,0,0,0,0,0,0
System.Web.Http.Description,ApiExplorerSettingsAttribute,0,0,0,0,0,0
System.Web.Http.Description,ApiParameterDescription,0,0,0,0,0,0
System.Web.Http.Description,ApiParameterSource,0,0,0,0,0,0
System.Web.WebPages.Deployment,AppDomainHelper,0,0,0,0,0,0
System.Web.WebPages.Deployment,AppDomainHelper.RemoteAssemblyLoader,0,0,0,0,0,0
System.Web.WebPages,ApplicationPart,0,0,0,0,0,0
System.Web.WebPages.ApplicationParts,ApplicationPartRegistry,0,0,0,0,0,0
System.Web.WebPages.Scope,ApplicationScopeStorageDictionary,0,0,0,0,0,0
Microsoft.Web.Mvc,AreaHelpers,0,0,0,0,0,0
System.Web.Mvc,AreaReference,0,0,0,0,0,0
System.Web.Mvc,AreaRegistration,0,0,0,0,0,0
System.Web.Mvc,AreaRegistrationContext,0,0,0,0,0,0
Microsoft.Web.Mvc.ModelBinding,ArrayModelBinder<TElement>,0,0,0,0,0,0
Microsoft.Web.Mvc.ModelBinding,ArrayModelBinderProvider,0,0,0,0,0,0
System.Web.WebPages.Scope,AspNetRequestScopeStorageProvider,0,0,0,0,0,0
System.Web.WebPages.Razor,AssemblyBuilderWrapper,0,0,0,0,0,0
System.Web.WebPages.Deployment,AssemblyUtils,0,0,0,0,0,0
System.Web.Mvc,AssociatedMetadataProvider,0,0,0,0,0,0
System.Web.Http.Metadata.Providers,AssociatedMetadataProvider<TModelMetadata>.PropertyInformation,0,0,0,0,0,0
System.Web.Http.Metadata.Providers,AssociatedMetadataProvider<TModelMetadata>.TypeInformation,0,0,0,0,0,0
System.Web.Http.Validation.Providers,AssociatedValidatorProvider,0,0,0,0,0,0
System.Web.Mvc.Async,AsyncActionDescriptor,0,0,0,0,0,0
System.Web.Mvc.Async,AsyncActionMethodSelector,0,0,0,0,0,0
System.Web.Mvc,AsyncController,0,0,0,0,0,0
System.Web.Mvc.Async,AsyncControllerActionInvoker.ActionInvocation,0,0,0,0,0,0
System.Web.Mvc.Async,AsyncManager,0,0,0,0,0,0
System.Web.Http.SelfHost.ServiceModel.Channels,AsyncResult.AsyncCompletion,0,0,0,0,0,0
System.Web.Mvc.Async,AsyncResultWrapper,0,0,0,0,0,0
System.Web.Mvc.Async,AsyncResultWrapper.CachedDelegates<TState>,0,0,0,0,0,0
System.Web.Mvc.Async,"AsyncResultWrapper.WrappedAsyncResult<TResult, TState>",0,0,0,0,0,0
System.Web.Mvc.Async,AsyncResultWrapper.WrappedAsyncResult<TResult>,0,0,0,0,0,0
System.Web.Mvc.Async,AsyncResultWrapper.WrappedAsyncResultBase<TResult>,0,0,0,0,0,0
System.Web.Mvc.Async,AsyncResultWrapper.WrappedAsyncVoid<TState>,0,0,0,0,0,0
System.Web.Mvc.Async,AsyncVoid,0,0,0,0,0,0
Microsoft.Web.Mvc.Resources,AtomEntryActionResult,0,0,0,0,0,0
Microsoft.Web.Mvc.Resources,AtomFeedActionResult,0,0,0,0,0,0
Microsoft.Web.Mvc.Resources,AtomServiceDocumentActionResult,0,0,0,0,0,0
System.Web.Razor.Generator,AttributeBlockCodeGenerator,0,0,0,0,0,0
System.ComponentModel,AttributeList,0,0,0,0,0,0
System.Web.WebPages,AttributeValue,0,0,0,0,0,0
System.Web.Mvc.Filters,AuthenticationChallengeContext,0,0,0,0,0,0
Microsoft.Web.WebPages.OAuth,AuthenticationClientData,0,0,0,0,0,0
System.Web.Mvc.Filters,AuthenticationContext,0,0,0,0,0,0
System.Web.Http.Controllers,AuthenticationFilterResult,0,0,0,0,0,0
System.Web.Http.Tracing.Tracers,AuthenticationFilterTracer,0,0,0,0,0,0
System.Web.Mvc,AuthorizationContext,0,0,0,0,0,0
System.Web.Http.Filters,AuthorizationFilterAttribute,0,0,0,0,0,0
System.Web.Http.Controllers,AuthorizationFilterResult,0,0,0,0,0,0
System.Web.Http.Tracing.Tracers,AuthorizationFilterTracer,0,0,0,0,0,0
System.Web.Razor.Parser.SyntaxTree,AutoCompleteEditHandler,0,0,0,0,0,0
System.Web.Razor.Editor,BackgroundParser,0,0,0,0,0,0
System.Web.Razor.Editor,BackgroundParser.MainThreadState,0,0,0,0,0,0
System.Web.Razor.Editor,BackgroundParser.ThreadStateBase,0,0,0,0,0,0
System.Web.Razor.Editor,BackgroundParser.WorkParcel,0,0,0,0,0,0
System.Web.Http.Results,BadRequestErrorMessageResult,0,0,0,0,0,0
System.Web.Http.Results,BadRequestResult,0,0,0,0,0,0
System.Web.Razor.Parser,BalancingModes,0,0,0,0,0,0
System.Web.Razor.Generator,BaseCodeWriter,0,0,0,0,0,0
System.Web.Http.Batch,BatchExecutionOrder,0,0,0,0,0,0
System.Web.Http.Batch,BatchHttpRequestContext,0,0,0,0,0,0
System.Web.Http.Batch,BatchHttpRequestMessageExtensions,0,0,0,0,0,0
System.Web.Mvc.Async,BeginInvokeDelegate,0,0,0,0,0,0
System.Web.Mvc.Async,BeginInvokeDelegate<TState>,0,0,0,0,0,0
System.Web.Helpers.AntiXsrf,BinaryBlob,0,0,0,0,0,0
Microsoft.Web.Mvc.ModelBinding,BinaryDataModelBinderProvider,0,0,0,0,0,0
Microsoft.Web.Mvc.ModelBinding,BinaryDataModelBinderProvider.ByteArrayExtensibleModelBinder,0,0,0,0,0,0
Microsoft.Web.Mvc.ModelBinding,BinaryDataModelBinderProvider.LinqBinaryExtensibleModelBinder,0,0,0,0,0,0
Microsoft.Web.Mvc.ExpressionUtil,BinaryExpressionFingerprint,0,0,0,0,0,0
System.Web.Mvc,BindAttribute,0,0,0,0,0,0
Microsoft.Web.Mvc.ModelBinding,BindingBehavior,0,0,0,0,0,0
Microsoft.Web.Mvc.ModelBinding,BindingBehaviorAttribute,0,0,0,0,0,0
Microsoft.Web.Mvc.ModelBinding,BindNeverAttribute,0,0,0,0,0,0
Microsoft.Web.Mvc.ModelBinding,BindRequiredAttribute,0,0,0,0,0,0
System.Web.Razor.Parser.SyntaxTree,BlockBuilder,0,0,0,0,0,0
System.Web.Razor.Generator,BlockCodeGenerator,0,0,0,0,0,0
System.Web.Razor.Generator,BlockCodeGenerator.NullBlockCodeGenerator,0,0,0,0,0,0
System.Web.Razor.Parser.SyntaxTree,BlockType,0,0,0,0,0,0
System.Web.Http.Routing.Constraints,BoolRouteConstraint,0,0,0,0,0,0
System.Web.Http.Routing,BoundRouteTemplate,0,0,0,0,0,0
System.Web.WebPages,BrowserHelpers,0,0,0,0,0,0
System.Web.WebPages,BrowserHelpers.UserAgentWorkerRequest,0,0,0,0,0,0
System.Web.WebPages,BrowserOverride,0,0,0,0,0,0
System.Web.WebPages,BrowserOverrideStore,0,0,0,0,0,0
System.Web.WebPages,BrowserOverrideStores,0,0,0,0,0,0
System.Net.Http.Formatting,BufferedMediaTypeFormatter,0,0,0,0,0,0
System.Web.Http.Tracing.Tracers,BufferedMediaTypeFormatterTracer,0,0,0,0,0,0
System.Web.Razor.Text,BufferingTextReader.BacktrackContext,0,0,0,0,0,0
System.Web.Mvc,BuildManagerCompiledView,0,0,0,0,0,0
System.Web.WebPages,BuildManagerExceptionUtil,0,0,0,0,0,0
System.Web.Mvc,BuildManagerViewEngine,0,0,0,0,0,0
System.Web.Mvc,BuildManagerViewEngine.DefaultViewPageActivator,0,0,0,0,0,0
System.Web.WebPages,BuildManagerWrapper.BuildManagerResult,0,0,0,0,0,0
Microsoft.Web.Mvc,ButtonBuilder,0,0,0,0,0,0
Microsoft.Web.Mvc,ButtonsAndLinkExtensions,0,0,0,0,0,0
System.Web.Mvc,ByteArrayModelBinder,0,0,0,0,0,0
System.Web.Mvc,CachedAssociatedMetadataProvider<TModelMetadata>,0,0,0,0,0,0
Microsoft.Web.Mvc,CachedExpressionCompiler,0,0,0,0,0,0
System.Web.Razor.Parser,CallbackVisitor,0,0,0,0,0,0
System.Web.Mvc,CancellationTokenModelBinder,0,0,0,0,0,0
System.Web.Http.ModelBinding,CancellationTokenParameterBinding,0,0,0,0,0,0
System.Web.Http.Routing,CandidateAction,0,0,0,0,0,0
Microsoft.AspNet.Facebook.Models,ChangeEntry,0,0,0,0,0,0
Microsoft.AspNet.Facebook.Models,ChangeNotification,0,0,0,0,0,0
System.Web.Http.SelfHost.ServiceModel.Channels,ChannelAcceptor<TChannel>,0,0,0,0,0,0
System.Web.Http.SelfHost.ServiceModel.Channels,ChannelBindingUtility,0,0,0,0,0,0
System.Web.Helpers,Chart.ChartAxisData,0,0,0,0,0,0
System.Web.Helpers,Chart.DataSourceData,0,0,0,0,0,0
System.Web.Helpers,Chart.LegendData,0,0,0,0,0,0
System.Web.Helpers,Chart.SeriesData,0,0,0,0,0,0
System.Web.Helpers,Chart.TitleData,0,0,0,0,0,0
System.Web.Helpers,ChartTheme,0,0,0,0,0,0
System.Web.Razor.Utils,CharUtils,0,0,0,0,0,0
System.Web.Mvc.Html,ChildActionExtensions.ChildActionMvcHandler,0,0,0,0,0,0
System.Web.Mvc,ChildActionOnlyAttribute,0,0,0,0,0,0
System.Web.Mvc,ChildActionValueProvider,0,0,0,0,0,0
System.Web.Mvc,ChildActionValueProviderFactory,0,0,0,0,0,0
System.Web.Helpers.Claims,Claim,0,0,0,0,0,0
System.Web.Helpers.Claims,Claim.ClaimFactory<TClaim>,0,0,0,0,0,0
System.Web.Helpers.Claims,ClaimsIdentity,0,0,0,0,0,0
System.Web.Helpers.Claims,"ClaimsIdentity.ClaimsIdentityImpl<TClaimsIdentity, TClaim>",0,0,0,0,0,0
System.Web.Helpers.Claims,ClaimsIdentityConverter,0,0,0,0,0,0
System.Web.Helpers.AntiXsrf,ClaimUidExtractor,0,0,0,0,0,0
System.Web.Mvc,ClientDataTypeModelValidatorProvider,0,0,0,0,0,0
System.Web.Mvc,ClientDataTypeModelValidatorProvider.ClientModelValidator,0,0,0,0,0,0
System.Web.Mvc,ClientDataTypeModelValidatorProvider.DateModelValidator,0,0,0,0,0,0
System.Web.Mvc,ClientDataTypeModelValidatorProvider.NumericModelValidator,0,0,0,0,0,0
System.Net.Http,CloneableExtensions,0,0,0,0,0,0
System.Web.Razor.Generator,CodeGenerationCompleteEventArgs,0,0,0,0,0,0
System.Web.Razor.Generator,CodeGeneratorContext.StatementBuffer,0,0,0,0,0,0
System.Web.Razor.Generator,CodeGeneratorPaddingHelper,0,0,0,0,0,0
System.Web.Razor.Generator,CodeWriter.WriterMode,0,0,0,0,0,0
System.Web.Razor.Generator,CodeWriterExtensions,0,0,0,0,0,0
Microsoft.Web.Mvc.ModelBinding,CollectionModelBinderProvider,0,0,0,0,0,0
ROOT_PROJECT_NAMESPACE.Areas.HelpPage.ModelDescriptions,CollectionModelDescription,0,0,0,0,0,0
System.Web.Mvc,CompareAttribute,0,0,0,0,0,0
System.Web.WebPages,CompareValidator,0,0,0,0,0,0
System.Web.WebPages.Razor,CompilingPathEventArgs,0,0,0,0,0,0
System.Web.Http.SelfHost.ServiceModel.Channels,CompletedAsyncResult,0,0,0,0,0,0
System.Web.Http.SelfHost.ServiceModel.Channels,CompletedAsyncResult<T>,0,0,0,0,0,0
Microsoft.Web.Mvc.ModelBinding,ComplexModelDto,0,0,0,0,0,0
Microsoft.Web.Mvc.ModelBinding,ComplexModelDtoModelBinder,0,0,0,0,0,0
Microsoft.Web.Mvc.ModelBinding,ComplexModelDtoModelBinderProvider,0,0,0,0,0,0
Microsoft.Web.Mvc.ModelBinding,ComplexModelDtoResult,0,0,0,0,0,0
ROOT_PROJECT_NAMESPACE.Areas.HelpPage.ModelDescriptions,ComplexTypeModelDescription,0,0,0,0,0,0
System.Web.Http.ExceptionHandling,CompositeExceptionLogger,0,0,0,0,0,0
System.Web.Http.ModelBinding.Binders,CompositeModelBinder,0,0,0,0,0,0
System.Web.Http.ModelBinding.Binders,CompositeModelBinderProvider,0,0,0,0,0,0
System.Web.Http.ValueProviders.Providers,CompositeValueProvider,0,0,0,0,0,0
System.Web.Http.ValueProviders.Providers,CompositeValueProviderFactory,0,0,0,0,0,0
System.Web.Http.Routing.Constraints,CompoundRouteConstraint,0,0,0,0,0,0
System.Web.Razor.Parser,ConditionalAttributeCollapser,0,0,0,0,0,0
Microsoft.Web.Mvc.ExpressionUtil,ConditionalExpressionFingerprint,0,0,0,0,0,0
System.Web.Http.Filters,ConfigurationFilterProvider,0,0,0,0,0,0
WebMatrix.Data,ConfigurationManagerWrapper,0,0,0,0,0,0
WebMatrix.WebData,ConfigUtil,0,0,0,0,0,0
System.Web.Http.Results,ConflictResult,0,0,0,0,0,0
WebMatrix.Data,ConnectionConfiguration,0,0,0,0,0,0
WebMatrix.Data,ConnectionEventArgs,0,0,0,0,0,0
Microsoft.Web.Mvc.ExpressionUtil,ConstantExpressionFingerprint,0,0,0,0,0,0
System.Web.Mvc.Routing,ConstraintValidation,0,0,0,0,0,0
System.Net.Http.Formatting,ContentNegotiationResult,0,0,0,0,0,0
System.Web.Http.Tracing.Tracers,ContentNegotiatorTracer,0,0,0,0,0,0
System.Web.Mvc,ContentResult,0,0,0,0,0,0
System.Web.Mvc,Controller.ExecuteCoreState,0,0,0,0,0,0
System.Web.Mvc,ControllerBase,0,0,0,0,0,0
System.Web.Mvc,ControllerBuilder,0,0,0,0,0,0
System.Web.Mvc,ControllerContext,0,0,0,0,0,0
System.Web.Mvc,ControllerContext.EmptyHttpContext,0,0,0,0,0,0
System.Web.Mvc,ControllerDescriptor,0,0,0,0,0,0
System.Web.Mvc,ControllerDescriptorCache,0,0,0,0,0,0
System.Web.Mvc,ControllerDescriptorExtensions,0,0,0,0,0,0
Microsoft.Web.Mvc,ControllerExtensions,0,0,0,0,0,0
System.Web.Mvc,ControllerInstanceFilterProvider,0,0,0,0,0,0
System.Web.Http.Controllers,ControllerServices,0,0,0,0,0,0
System.Web.Mvc,ControllerTypeCache,0,0,0,0,0,0
System.Web.Helpers,ConversionUtil,0,0,0,0,0,0
System.Web.WebPages,CookieBrowserOverrideStore,0,0,0,0,0,0
System.Net.Http.Headers,CookieState,0,0,0,0,0,0
Microsoft.Web.Mvc,CookieValueProviderFactory,0,0,0,0,0,0
System.Web.Mvc,"CopyOnWriteDictionary<TKey, TValue>",0,0,0,0,0,0
System.Web.Cors,CorsConstants,0,0,0,0,0,0
System.Web.Cors,CorsEngine,0,0,0,0,0,0
System.Web.Http.Cors.Tracing,CorsEngineTracer,0,0,0,0,0,0
System.Web.Http,CorsHttpConfigurationExtensions,0,0,0,0,0,0
System.Web.Http.Cors,CorsHttpRequestMessageExtensions,0,0,0,0,0,0
System.Web.Http.Cors,CorsHttpResponseMessageExtensions,0,0,0,0,0,0
System.Web.Http.Cors,CorsMessageHandler,0,0,0,0,0,0
System.Web.Cors,CorsPolicy,0,0,0,0,0,0
System.Web.Http.Cors.Tracing,CorsPolicyProviderFactoryTracer,0,0,0,0,0,0
System.Web.Http.Cors.Tracing,CorsPolicyProviderTracer,0,0,0,0,0,0
System.Web.Cors,CorsRequestContext,0,0,0,0,0,0
System.Web.Cors,CorsResult,0,0,0,0,0,0
System.Web.Http.Results,CreatedAtRouteNegotiatedContentResult<T>,0,0,0,0,0,0
System.Web.Http.Results,CreatedAtRouteNegotiatedContentResult<T>.ApiControllerDependencyProvider,0,0,0,0,0,0
System.Web.Http.Results,CreatedAtRouteNegotiatedContentResult<T>.DirectDependencyProvider,0,0,0,0,0,0
System.Web.Http.Results,CreatedAtRouteNegotiatedContentResult<T>.IDependencyProvider,0,0,0,0,0,0
System.Web.Http.Results,CreatedNegotiatedContentResult<T>,0,0,0,0,0,0
System.Web.Helpers,Crypto,0,0,0,0,0,0
System.Web.Helpers,CryptoUtil,0,0,0,0,0,0
System.Web.Razor.Parser,CSharpCodeParser.Block,0,0,0,0,0,0
System.Web.Razor.Generator,CSharpCodeWriter,0,0,0,0,0,0
System.Web.Razor.Tokenizer,CSharpHelpers,0,0,0,0,0,0
System.Web.Razor.Tokenizer.Symbols,CSharpKeyword,0,0,0,0,0,0
System.Web.Razor.Tokenizer,CSharpKeywordDetector,0,0,0,0,0,0
System.Web.Razor.Parser,CSharpLanguageCharacteristics,0,0,0,0,0,0
System.Web.Razor.Generator,CSharpRazorCodeGenerator,0,0,0,0,0,0
System.Web.Razor,CSharpRazorCodeLanguage,0,0,0,0,0,0
System.Web.Razor.Tokenizer.Symbols,CSharpSymbol,0,0,0,0,0,0
System.Web.Razor.Tokenizer.Symbols,CSharpSymbolType,0,0,0,0,0,0
Microsoft.Web.Mvc,CssExtensions,0,0,0,0,0,0
System.Web.WebPages,CultureUtil,0,0,0,0,0,0
System.Web.Http.ModelBinding,CustomModelBinderAttribute,0,0,0,0,0,0
System.Web.Mvc,DataAnnotationsModelMetadata,0,0,0,0,0,0
System.Web.Http.Validation.Providers,DataAnnotationsModelValidationFactory,0,0,0,0,0,0
System.Web.Http.Validation.Validators,DataAnnotationsModelValidator,0,0,0,0,0,0
System.Web.Mvc,DataAnnotationsModelValidator<TAttribute>,0,0,0,0,0,0
System.Web.Http.Validation.Providers,DataAnnotationsValidatableObjectAdapterFactory,0,0,0,0,0,0
WebMatrix.WebData,DatabaseConnectionInfo,0,0,0,0,0,0
WebMatrix.WebData,DatabaseConnectionInfo.ConnectionType,0,0,0,0,0,0
WebMatrix.WebData,DatabaseWrapper,0,0,0,0,0,0
Microsoft.Web.Mvc.Resources,DataContractJsonActionResult,0,0,0,0,0,0
Microsoft.Web.Mvc.Resources,DataContractXmlActionResult,0,0,0,0,0,0
System.Web.Mvc,DataErrorInfoModelValidatorProvider,0,0,0,0,0,0
System.Web.Mvc,DataErrorInfoModelValidatorProvider.DataErrorInfoClassModelValidator,0,0,0,0,0,0
System.Web.Mvc,DataErrorInfoModelValidatorProvider.DataErrorInfoPropertyModelValidator,0,0,0,0,0,0
System.Web.Http.Validation.Providers,DataMemberModelValidatorProvider,0,0,0,0,0,0
System.Web.Mvc,DataTypeAttributeAdapter,0,0,0,0,0,0
System.Web.Mvc,DataTypeUtil,0,0,0,0,0,0
System.Web.WebPages,DataTypeValidator,0,0,0,0,0,0
System.Web.WebPages,DataTypeValidator.SupportedValidationDataType,0,0,0,0,0,0
System.Web.Http.Routing.Constraints,DateTimeRouteConstraint,0,0,0,0,0,0
WebMatrix.Data,DbProviderFactoryWrapper,0,0,0,0,0,0
System.Web.Http.Routing.Constraints,DecimalRouteConstraint,0,0,0,0,0,0
System.Web.Http.Services,Decorator,0,0,0,0,0,0
System.Web.Http.ModelBinding,DefaultActionValueBinder,0,0,0,0,0,0
System.Web.Http.Dispatcher,DefaultAssembliesResolver,0,0,0,0,0,0
System.Web.Http.Validation,DefaultBodyModelValidator.ElementScope,0,0,0,0,0,0
System.Web.Http.Validation,DefaultBodyModelValidator.IKeyBuilder,0,0,0,0,0,0
System.Web.Http.Validation,DefaultBodyModelValidator.PropertyScope,0,0,0,0,0,0
System.Web.Http.Validation,DefaultBodyModelValidator.ValidationContext,0,0,0,0,0,0
System.Web.Mvc,DefaultControllerFactory.DefaultControllerActivator,0,0,0,0,0,0
System.Web.WebPages,DefaultDisplayMode,0,0,0,0,0,0
System.Web.Http.ExceptionHandling,DefaultExceptionHandler,0,0,0,0,0,0
Microsoft.Web.Mvc.ExpressionUtil,DefaultExpressionFingerprint,0,0,0,0,0,0
Microsoft.AspNet.Facebook.Providers,DefaultFacebookClientProvider,0,0,0,0,0,0
Microsoft.AspNet.Facebook.Providers,DefaultFacebookPermissionService,0,0,0,0,0,0
Microsoft.Web.Mvc.Resources,DefaultFormatHelper,0,0,0,0,0,0
Microsoft.Web.Mvc.Resources,DefaultFormatHelper.AcceptHeaderElementComparer,0,0,0,0,0,0
Microsoft.Web.Mvc.Resources,DefaultFormatManager,0,0,0,0,0,0
System.Web.Http.Dispatcher,DefaultHttpControllerActivator,0,0,0,0,0,0
System.Web.Http.Dispatcher,DefaultHttpControllerTypeResolver,0,0,0,0,0,0
System.Web.Http.Tracing.Tracers,DefaultHttpControllerTypeResolverTracer,0,0,0,0,0,0
System.Web.Mvc,DefaultModelBinder.CollectionHelpers,0,0,0,0,0,0
System.Web.Mvc,DefaultViewLocationCache,0,0,0,0,0,0
System.Net.Http.Formatting,DelegatingEnumerable<T>,0,0,0,0,0,0
System.Web.Mvc,DependencyResolver,0,0,0,0,0,0
System.Web.Mvc,DependencyResolver.CacheDependencyResolver,0,0,0,0,0,0
System.Web.Mvc,DependencyResolver.DefaultDependencyResolver,0,0,0,0,0,0
System.Web.Mvc,DependencyResolver.DelegateBasedDependencyResolver,0,0,0,0,0,0
System.Web.Mvc,DependencyResolverExtensions,0,0,0,0,0,0
System.Web.Mvc,DescriptorUtil,0,0,0,0,0,0
Microsoft.Web.Mvc,DeserializeAttribute,0,0,0,0,0,0
Microsoft.Web.Mvc,DeserializeAttribute.DeserializingModelBinder,0,0,0,0,0,0
System.Web.WebPages.ApplicationParts,DictionaryBasedVirtualPathFactory,0,0,0,0,0,0
System.Web.Mvc,DictionaryHelpers,0,0,0,0,0,0
Microsoft.Web.Mvc.ModelBinding,"DictionaryModelBinder<TKey, TValue>",0,0,0,0,0,0
Microsoft.Web.Mvc.ModelBinding,DictionaryModelBinderProvider,0,0,0,0,0,0
ROOT_PROJECT_NAMESPACE.Areas.HelpPage.ModelDescriptions,DictionaryModelDescription,0,0,0,0,0,0
System.Web.Mvc,DictionaryValueProvider<TValue>,0,0,0,0,0,0
System.Web.Http.Cors,DisableCorsAttribute,0,0,0,0,0,0
System.Web.Mvc.Html,DisplayExtensions,0,0,0,0,0,0
System.Web.WebPages,DisplayInfo,0,0,0,0,0,0
System.Web.WebPages,DisplayModeProvider,0,0,0,0,0,0
System.Web.Mvc.Html,DisplayNameExtensions,0,0,0,0,0,0
System.Web.Mvc.Html,DisplayTextExtensions,0,0,0,0,0,0
System.Web.Razor.Utils,DisposableAction,0,0,0,0,0,0
System.Web.Razor,DocumentParseCompleteEventArgs,0,0,0,0,0,0
System.Web.Http.Routing.Constraints,DoubleRouteConstraint,0,0,0,0,0,0
Microsoft.Internal.Web.Utils,DynamicHelper,0,0,0,0,0,0
System.Web.WebPages,DynamicHttpApplicationState,0,0,0,0,0,0
System.Web.Helpers,DynamicJavaScriptConverter,0,0,0,0,0,0
System.Web.Helpers,DynamicJsonArray,0,0,0,0,0,0
System.Web.Helpers,DynamicJsonObject,0,0,0,0,0,0
WebMatrix.Data,DynamicRecord.DynamicPropertyDescriptor,0,0,0,0,0,0
Microsoft.Web.Mvc,DynamicReflectionObject,0,0,0,0,0,0
Microsoft.Web.Mvc,DynamicViewDataDictionary,0,0,0,0,0,0
System.Web.Mvc.Html,EditorExtensions,0,0,0,0,0,0
System.Web.Razor.Editor,EditorHints,0,0,0,0,0,0
System.Web.Razor.Editor,EditResult,0,0,0,0,0,0
System.Web.Http,"EfficientTypePropertyKey<T1, T2>",0,0,0,0,0,0
Microsoft.Web.Mvc,ElementalValueProvider,0,0,0,0,0,0
System.Collections.Generic,Empty<T>,0,0,0,0,0,0
System.Web.Http.ExceptionHandling,EmptyExceptionHandler,0,0,0,0,0,0
System.Web.Http.Owin.ExceptionHandling,EmptyExceptionLogger,0,0,0,0,0,0
System.Web.Http.Metadata.Providers,EmptyModelMetadataProvider,0,0,0,0,0,0
System.Web.Mvc,EmptyModelValidatorProvider,0,0,0,0,0,0
System.Web.Http,"EmptyReadOnlyDictionary<TKey, TValue>",0,0,0,0,0,0
System.Web.Http.Dependencies,EmptyResolver,0,0,0,0,0,0
System.Web.Mvc,EmptyResult,0,0,0,0,0,0
System.Web.Http.Cors,EnableCorsAttribute,0,0,0,0,0,0
Microsoft.Web.Mvc.Controls,EncodeType,0,0,0,0,0,0
System.Web.Mvc.Async,EndInvokeDelegate<TResult>,0,0,0,0,0,0
System.Web.Mvc.Async,"EndInvokeDelegate<TState, TResult>",0,0,0,0,0,0
System.Web.Mvc.Async,EndInvokeVoidDelegate<TState>,0,0,0,0,0,0
System.Web.Razor.Utils,EnumeratorExtensions,0,0,0,0,0,0
System.Web.Mvc.Html,EnumHelper,0,0,0,0,0,0
ROOT_PROJECT_NAMESPACE.Areas.HelpPage.ModelDescriptions,EnumTypeModelDescription,0,0,0,0,0,0
System.Web.Razor.Utils,EnumUtil,0,0,0,0,0,0
ROOT_PROJECT_NAMESPACE.Areas.HelpPage.ModelDescriptions,EnumValueDescription,0,0,0,0,0,0
System.Web.Razor.Parser.SyntaxTree,EquivalenceComparer,0,0,0,0,0,0
System.Web.Http.Validation.Validators,ErrorModelValidator,0,0,0,0,0,0
System.Web.Http.ModelBinding,ErrorParameterBinding,0,0,0,0,0,0
System.Web.Http.ExceptionHandling,ExceptionCatchBlocks,0,0,0,0,0,0
System.Web.Http.ExceptionHandling,ExceptionContextCatchBlock,0,0,0,0,0,0
System.Web.Http.Filters,ExceptionFilterAttribute,0,0,0,0,0,0
System.Web.Http.Controllers,ExceptionFilterResult,0,0,0,0,0,0
System.Web.Http.Tracing.Tracers,ExceptionFilterTracer,0,0,0,0,0,0
System.Web.Http.ExceptionHandling,ExceptionHandler,0,0,0,0,0,0
System.Web.Http.ExceptionHandling,ExceptionHandlerContext,0,0,0,0,0,0
System.Web.Http.ExceptionHandling,ExceptionHandlerExtensions,0,0,0,0,0,0
System.Web.Http.ExceptionHandling,ExceptionLogger,0,0,0,0,0,0
System.Web.Http.ExceptionHandling,ExceptionLoggerContext,0,0,0,0,0,0
System.Web.Http.ExceptionHandling,ExceptionLoggerExtensions,0,0,0,0,0,0
System.Web.Http.Results,ExceptionResult,0,0,0,0,0,0
System.Web.Http.Results,ExceptionResult.ApiControllerDependencyProvider,0,0,0,0,0,0
System.Web.Http.Results,ExceptionResult.DirectDependencyProvider,0,0,0,0,0,0
System.Web.Http.Results,ExceptionResult.IDependencyProvider,0,0,0,0,0,0
System.Web.Http.ExceptionHandling,ExceptionServices,0,0,0,0,0,0
System.Web.Razor.Generator,ExpressionCodeGenerator,0,0,0,0,0,0
Microsoft.Web.Mvc.ExpressionUtil,ExpressionFingerprint,0,0,0,0,0,0
Microsoft.Web.Mvc.ExpressionUtil,ExpressionFingerprintChain,0,0,0,0,0,0
System.Web.Razor.Generator,ExpressionRenderingMode,0,0,0,0,0,0
Microsoft.Web.Mvc.ModelBinding,ExtensibleModelBinderAdapter,0,0,0,0,0,0
Microsoft.Web.Mvc.ModelBinding,ExtensibleModelBinderAttribute,0,0,0,0,0,0
Microsoft.Web.Mvc.ModelBinding,ExtensibleModelBindingContext,0,0,0,0,0,0
Microsoft.AspNet.Facebook,FacebookAppSettingKeys,0,0,0,0,0,0
Microsoft.AspNet.Facebook,FacebookAuthenticationModule,0,0,0,0,0,0
Microsoft.AspNet.Facebook,FacebookAuthorizeAttribute,0,0,0,0,0,0
Microsoft.AspNet.Facebook.Client,FacebookClientExtensions,0,0,0,0,0,0
Microsoft.AspNet.Facebook,FacebookConfiguration,0,0,0,0,0,0
Microsoft.AspNet.Facebook,FacebookConnection<T>,0,0,0,0,0,0
Microsoft.AspNet.Facebook,FacebookContext,0,0,0,0,0,0
Microsoft.AspNet.Facebook.ModelBinders,FacebookContextBinderAttribute,0,0,0,0,0,0
Microsoft.AspNet.Facebook,FacebookFieldModifierAttribute,0,0,0,0,0,0
Microsoft.AspNet.Facebook,FacebookGroupConnection<T>,0,0,0,0,0,0
Microsoft.AspNet.Facebook,FacebookHtmlHelperExtensions,0,0,0,0,0,0
Microsoft.AspNet.Facebook.Client,FacebookQueryHelper,0,0,0,0,0,0
Microsoft.AspNet.Facebook.Realtime,FacebookRealtimeUpdateController,0,0,0,0,0,0
Microsoft.AspNet.Facebook,FacebookRedirectContext,0,0,0,0,0,0
Microsoft.AspNet.Facebook.ModelBinders,FacebookRedirectContextBinderAttribute,0,0,0,0,0,0
Microsoft.AspNet.Facebook.ModelBinders,FacebookRedirectContextModelBinder,0,0,0,0,0,0
Microsoft.AspNet.Facebook.Client,FacebookRequestHelpers,0,0,0,0,0,0
System.Web.Mvc,FieldValidationMetadata,0,0,0,0,0,0
System.Web.Mvc,FileContentResult,0,0,0,0,0,0
System.Web.WebPages,FileExistenceCache,0,0,0,0,0,0
System.Web.Mvc,FilePathResult,0,0,0,0,0,0
System.Web.Mvc,FileResult,0,0,0,0,0,0
System.Web.Mvc,FileResult.ContentDispositionUtil,0,0,0,0,0,0
System.Web.Mvc,FileStreamResult,0,0,0,0,0,0
System.Web.Mvc,Filter,0,0,0,0,0,0
System.Web.Http.Filters,FilterAttribute,0,0,0,0,0,0
System.Web.Mvc,FilterAttributeFilterProvider,0,0,0,0,0,0
System.Web.Http.Controllers,FilterGrouping,0,0,0,0,0,0
System.Web.Mvc,FilterInfo.OverrideFilterInfo,0,0,0,0,0,0
System.Web.Http.Filters,FilterInfoComparer,0,0,0,0,0,0
System.Web.Mvc,FilterProviderCollection,0,0,0,0,0,0
System.Web.Mvc,FilterProviderCollection.FilterComparer,0,0,0,0,0,0
System.Web.Mvc,FilterProviders,0,0,0,0,0,0
System.Web.Http.Filters,FilterScope,0,0,0,0,0,0
System.Web.Http.Routing.Constraints,FloatRouteConstraint,0,0,0,0,0,0
Microsoft.Web.Mvc.Resources,FormatHelper,0,0,0,0,0,0
Microsoft.Web.Mvc.Resources,FormatManager,0,0,0,0,0,0
System.Web.Http.Results,FormattedContentResult<T>,0,0,0,0,0,0
System.Web.Http.Tracing.Tracers,FormatterLoggerTraceWrapper,0,0,0,0,0,0
System.Web.Mvc,FormCollection,0,0,0,0,0,0
System.Web.Mvc,FormCollection.FormCollectionBinderAttribute,0,0,0,0,0,0
System.Web.Mvc,FormCollection.FormCollectionBinderAttribute.FormCollectionModelBinder,0,0,0,0,0,0
System.Web.Mvc,FormContext,0,0,0,0,0,0
System.Net.Http.Formatting,FormDataCollection,0,0,0,0,0,0
System.Web.Http.ModelBinding,FormDataCollectionExtensions.ServicesContainerWrapper,0,0,0,0,0,0
System.Web.Mvc,FormMethod,0,0,0,0,0,0
WebMatrix.WebData,FormsAuthenticationSettings,0,0,0,0,0,0
System.Net.Http.Formatting,FormUrlEncodedJson.ArrayCandidate,0,0,0,0,0,0
System.Net.Http.Formatting,FormUrlEncodedMediaTypeFormatter,0,0,0,0,0,0
System.Web.Http.Tracing.Tracers,FormUrlEncodedMediaTypeFormatterTracer,0,0,0,0,0,0
System.Net.Http.Formatting.Parsers,FormUrlEncodedParser.CurrentNameValuePair,0,0,0,0,0,0
System.Net.Http.Formatting.Parsers,FormUrlEncodedParser.NameValueState,0,0,0,0,0,0
System.Web.Mvc,FormValueProvider,0,0,0,0,0,0
System.Web.Mvc,FormValueProviderFactory,0,0,0,0,0,0
System.Web.Http,FromBodyAttribute,0,0,0,0,0,0
System.Web.Razor.Generator,GeneratedCodeMapping,0,0,0,0,0,0
System.Web.Razor,GeneratorResults,0,0,0,0,0,0
Microsoft.Web.Mvc.ModelBinding,GenericModelBinderProvider,0,0,0,0,0,0
System.Web.Http,GlobalConfiguration,0,0,0,0,0,0
Microsoft.AspNet.Facebook,GlobalFacebookConfiguration,0,0,0,0,0,0
System.Web.Mvc,GlobalFilterCollection,0,0,0,0,0,0
System.Web.Mvc,GlobalFilters,0,0,0,0,0,0
Microsoft.Web.Helpers,Gravatar,0,0,0,0,0,0
Microsoft.Web.Helpers,GravatarRating,0,0,0,0,0,0
System.Web.Http.Routing.Constraints,GuidRouteConstraint,0,0,0,0,0,0
System.Web.Mvc,HandleErrorAttribute,0,0,0,0,0,0
System.Web.Mvc,HandleErrorInfo,0,0,0,0,0,0
ROOT_PROJECT_NAMESPACE.Areas.HelpPage.Controllers,HelpController,0,0,0,0,0,0
System.Web.Razor.Generator,HelperCodeGenerator,0,0,0,0,0,0
System.Web.WebPages,HelperResult,0,0,0,0,0,0
ROOT_PROJECT_NAMESPACE.Areas.HelpPage.Models,HelpPageApiModel,0,0,0,0,0,0
ROOT_PROJECT_NAMESPACE.Areas.HelpPage,HelpPageAreaRegistration,0,0,0,0,0,0
ROOT_PROJECT_NAMESPACE.Areas.HelpPage,HelpPageConfig,0,0,0,0,0,0
ROOT_PROJECT_NAMESPACE.Areas.HelpPage,HelpPageSampleKey,0,0,0,0,0,0
System.Web.Mvc,HiddenInputAttribute,0,0,0,0,0,0
Microsoft.Web.Mvc.ExpressionUtil,"Hoisted<TModel, TValue>",0,0,0,0,0,0
Microsoft.Web.Mvc.ExpressionUtil,"HoistingExpressionVisitor<TIn, TOut>",0,0,0,0,0,0
System.Web.Http,HostAuthenticationAttribute,0,0,0,0,0,0
System.Web.Http,HostAuthenticationFilter,0,0,0,0,0,0
System.Web.Http.WebHost.Routing,HostedHttpRoute,0,0,0,0,0,0
System.Web.Http.WebHost.Routing,HostedHttpRouteData,0,0,0,0,0,0
System.Web.Http.WebHost.Routing,HostedHttpVirtualPathData,0,0,0,0,0,0
System.Web.WebPages.Razor,HostingEnvironmentWrapper,0,0,0,0,0,0
System.Web.Http.SelfHost.ServiceModel,HostNameComparisonModeHelper,0,0,0,0,0,0
System.Web.WebPages.Razor.Configuration,HostSection,0,0,0,0,0,0
System.Web.Mvc,Html5DateRenderingMode,0,0,0,0,0,0
System.Web.WebPages,HtmlAttributePropertyHelper,0,0,0,0,0,0
Microsoft.Web.Mvc,HtmlButtonType,0,0,0,0,0,0
System.Web.Helpers,HtmlElement,0,0,0,0,0,0
System.Web.WebPages.Html,HtmlHelper.InputType,0,0,0,0,0,0
System.Web.Mvc,HtmlHelper<TModel>,0,0,0,0,0,0
System.Web.Razor.Parser,HtmlLanguageCharacteristics,0,0,0,0,0,0
System.Web.Razor.Tokenizer.Symbols,HtmlSymbol,0,0,0,0,0,0
System.Web.Razor.Tokenizer.Symbols,HtmlSymbolType,0,0,0,0,0,0
System.Web.Razor.Tokenizer,HtmlTokenizer,0,0,0,0,0,0
System.Web.Http.Controllers,HttpActionBinding,0,0,0,0,0,0
System.Web.Http.Tracing.Tracers,HttpActionBindingTracer,0,0,0,0,0,0
System.Web.Http.Controllers,HttpActionContext,0,0,0,0,0,0
System.Web.Http.Controllers,HttpActionContextExtensions,0,0,0,0,0,0
System.Web.Http.Controllers,HttpActionDescriptorExtensions,0,0,0,0,0,0
System.Web.Http.Filters,HttpActionExecutedContext,0,0,0,0,0,0
System.Web.Http.Tracing.Tracers,HttpActionInvokerTracer,0,0,0,0,0,0
System.Web.Http.Tracing.Tracers,HttpActionSelectorTracer,0,0,0,0,0,0
System.Web.Http.Filters,HttpAuthenticationChallengeContext,0,0,0,0,0,0
System.Web.Http.Filters,HttpAuthenticationContext,0,0,0,0,0,0
System.Web.Http.WebHost,HttpBatchContextWrapper,0,0,0,0,0,0
System.Web.Http.Batch,HttpBatchHandler,0,0,0,0,0,0
System.Web.Http.ModelBinding,HttpBindingBehavior,0,0,0,0,0,0
System.Web.Http.ModelBinding,HttpBindingBehaviorAttribute,0,0,0,0,0,0
System.Web.Http.SelfHost.Channels,HttpBindingSecurity,0,0,0,0,0,0
System.Web.Http.SelfHost.Channels,HttpBindingSecurityMode,0,0,0,0,0,0
System.Web.Http.SelfHost.Channels,HttpBindingSecurityModeHelper,0,0,0,0,0,0
System.Web.Http,HttpBindNeverAttribute,0,0,0,0,0,0
System.Web.Http,HttpBindRequiredAttribute,0,0,0,0,0,0
System.Web.Http.SelfHost.ServiceModel,HttpClientCredentialTypeHelper,0,0,0,0,0,0
System.Net.Http,HttpClientFactory,0,0,0,0,0,0
System.Web.Http,HttpConfigurationTracingExtensions,0,0,0,0,0,0
System.Net.Http,HttpContentExtensions,0,0,0,0,0,0
System.Net.Http,HttpContentFormDataExtensions,0,0,0,0,0,0
System.Net.Http,HttpContentMultipartExtensions,0,0,0,0,0,0
System.Net.Http,HttpContentMultipartExtensions.MultipartAsyncContext,0,0,0,0,0,0
System.Web.Http.WebHost.Routing,HttpContextBaseExtensions,0,0,0,0,0,0
System.Web.WebPages,HttpContextExtensions,0,0,0,0,0,0
System.Web.Http.Tracing.Tracers,HttpControllerActivatorTracer,0,0,0,0,0,0
System.Web.Http.Controllers,HttpControllerContext,0,0,0,0,0,0
System.Web.Http.Controllers,HttpControllerDescriptor,0,0,0,0,0,0
System.Web.Http.Controllers,HttpControllerDescriptorExtensions,0,0,0,0,0,0
System.Web.Http.Tracing.Tracers,HttpControllerDescriptorTracer,0,0,0,0,0,0
System.Web.Http.Dispatcher,HttpControllerDispatcher,0,0,0,0,0,0
System.Web.Http.WebHost,HttpControllerHandler.DelegatingStreamContent,0,0,0,0,0,0
System.Web.Http.WebHost,HttpControllerHandler.LazyStreamContent,0,0,0,0,0,0
System.Web.Http.WebHost,HttpControllerRouteHandler,0,0,0,0,0,0
System.Web.Http.Tracing.Tracers,HttpControllerSelectorTracer,0,0,0,0,0,0
System.Web.Http.Controllers,HttpControllerSettings,0,0,0,0,0,0
System.Web.Http.Tracing.Tracers,HttpControllerTracer,0,0,0,0,0,0
System.Web.Http.Dispatcher,HttpControllerTypeCache,0,0,0,0,0,0
System.Web.Http.WebHost,HttpControllerTypeCacheSerializer,0,0,0,0,0,0
System.Web.Http,HttpDeleteAttribute,0,0,0,0,0,0
System.Web.Http,HttpError,0,0,0,0,0,0
System.Web.Http,HttpErrorKeys,0,0,0,0,0,0
System.Web.Mvc,HttpFileCollectionValueProvider,0,0,0,0,0,0
System.Web.Mvc,HttpFileCollectionValueProviderFactory,0,0,0,0,0,0
System.Web.Http.Filters,HttpFilterCollection,0,0,0,0,0,0
System.Web.Http,HttpGetAttribute,0,0,0,0,0,0
System.Web.Mvc,HttpHandlerUtil,0,0,0,0,0,0
System.Web.Http,HttpHeadAttribute,0,0,0,0,0,0
System.Net.Http,HttpHeaderExtensions,0,0,0,0,0,0
System.Web.Http.SelfHost.Channels,HttpMessageEncoderFactory,0,0,0,0,0,0
System.Web.Http.SelfHost.Channels,HttpMessageEncoderFactory.HttpMessageEncoder,0,0,0,0,0,0
System.Web.Http.SelfHost.Channels,HttpMessageEncoderFactory.HttpMessageEncoder.ByteArrayBufferManagerContent,0,0,0,0,0,0
System.Web.Http.SelfHost.Channels,HttpMessageEncodingBindingElement,0,0,0,0,0,0
System.Web.Http.SelfHost.Channels,HttpMessageExtensions,0,0,0,0,0,0
System.Web.Http.Owin,HttpMessageHandlerOptions,0,0,0,0,0,0
System.Web.Http.Routing,HttpMethodConstraint,0,0,0,0,0,0
System.Web.Http,HttpMethodHelper,0,0,0,0,0,0
System.Web.Mvc,HttpNotFoundResult,0,0,0,0,0,0
System.Web.Http,HttpOptionsAttribute,0,0,0,0,0,0
System.Web.Http.Controllers,HttpParameterBinding,0,0,0,0,0,0
System.Web.Http.Internal,HttpParameterBindingExtensions,0,0,0,0,0,0
System.Web.Http.Tracing.Tracers,HttpParameterBindingTracer,0,0,0,0,0,0
System.Web.Http.Controllers,HttpParameterDescriptor,0,0,0,0,0,0
System.Web.Http.Controllers,HttpParameterDescriptor.AmbiguousParameterBindingAttribute,0,0,0,0,0,0
System.Web.Http,HttpPatchAttribute,0,0,0,0,0,0
System.Web.Http,HttpPostAttribute,0,0,0,0,0,0
System.Web.Mvc,HttpPostedFileBaseModelBinder,0,0,0,0,0,0
System.Net.Http.Handlers,HttpProgressEventArgs,0,0,0,0,0,0
System.Web.Http.Hosting,HttpPropertyKeys,0,0,0,0,0,0
System.Web.Http.SelfHost.ServiceModel,HttpProxyCredentialTypeHelper,0,0,0,0,0,0
System.Web.Http,HttpPutAttribute,0,0,0,0,0,0
Microsoft.Web.Mvc.Resources,HttpRequestBaseExtensions,0,0,0,0,0,0
System.Web.Http.Controllers,HttpRequestContext,0,0,0,0,0,0
System.Web.Mvc,HttpRequestExtensions,0,0,0,0,0,0
System.Net.Http.Formatting.Parsers,HttpRequestHeaderParser,0,0,0,0,0,0
System.Net.Http.Formatting.Parsers,HttpRequestHeaderParser.HttpRequestState,0,0,0,0,0,0
System.Net.Http,HttpRequestHeadersExtensions,0,0,0,0,0,0
System.Net.Http.Formatting.Parsers,HttpRequestLineParser.HttpRequestLineState,0,0,0,0,0,0
System.Web.Http.WebHost.Routing,HttpRequestMessageContextWrapper,0,0,0,0,0,0
System.Web.Http.WebHost.Routing,HttpRequestMessageWrapper,0,0,0,0,0,0
System.Web.Http.ModelBinding,HttpRequestParameterBinding,0,0,0,0,0,0
System.Web.Http.WebHost,HttpResponseBaseExtensions,0,0,0,0,0,0
System.Web.Http,HttpResponseException,0,0,0,0,0,0
System.Net.Http.Formatting.Parsers,HttpResponseHeaderParser,0,0,0,0,0,0
System.Net.Http.Formatting.Parsers,HttpResponseHeaderParser.HttpResponseState,0,0,0,0,0,0
System.Net.Http,HttpResponseHeadersExtensions,0,0,0,0,0,0
System.Net.Http,HttpResponseMessageExtensions,0,0,0,0,0,0
System.Web.Http,HttpRouteCollectionExtensions,0,0,0,0,0,0
System.Web.Http,HttpRouteCollectionExtensions.IgnoreHttpRouteInternal,0,0,0,0,0,0
System.Web.Http.Routing,HttpRouteData,0,0,0,0,0,0
System.Web.Http.Routing,HttpRouteDataExtensions,0,0,0,0,0,0
System.Web.Http.Routing,HttpRouteDirection,0,0,0,0,0,0
System.Web.Http.WebHost.Routing,HttpRouteExceptionHandler,0,0,0,0,0,0
System.Web.Http.WebHost.Routing,HttpRouteExceptionRouteHandler,0,0,0,0,0,0
System.Web.Http.Routing,HttpRouteExtensions,0,0,0,0,0,0
System.Web.Http.Routing,HttpRouteValueDictionary,0,0,0,0,0,0
System.Web.Http.Dispatcher,HttpRoutingDispatcher,0,0,0,0,0,0
System.Web.Http.SelfHost,HttpSelfHostServer.ChannelContext,0,0,0,0,0,0
System.Web.Http.SelfHost,HttpSelfHostServer.ReplyContext,0,0,0,0,0,0
System.Web.Http,HttpServer,0,0,0,0,0,0
System.Web.Mvc,HttpStatusCodeResult,0,0,0,0,0,0
System.Net.Http.Formatting.Parsers,HttpStatusLineParser.HttpStatusLineState,0,0,0,0,0,0
System.Web.Http.SelfHost.ServiceModel.Channels,HttpTransportDefaults,0,0,0,0,0,0
System.Web.Http.SelfHost.ServiceModel,HttpTransportSecurityExtensionMethods,0,0,0,0,0,0
System.Web.Mvc,HttpUnauthorizedResult,0,0,0,0,0,0
System.Net.Http,HttpUnsortedHeaders,0,0,0,0,0,0
System.Net.Http,HttpUnsortedRequest,0,0,0,0,0,0
System.Net.Http,HttpUnsortedResponse,0,0,0,0,0,0
System.Net.Http.Formatting.Internal,HttpValueCollection,0,0,0,0,0,0
System.Web.Mvc,HttpVerbs,0,0,0,0,0,0
System.Web.Http.Routing,HttpVirtualPathData,0,0,0,0,0,0
System.Web.Http,HubController,0,0,0,0,0,0
System.Web.Http,HubController<THub>,0,0,0,0,0,0
System.Web.Http,HubControllerBase,0,0,0,0,0,0
System.Web.Razor.Generator,HybridCodeGenerator,0,0,0,0,0,0
System.Web.Http.Filters,IActionFilter,0,0,0,0,0,0
System.Web.Http.Controllers,IActionHttpMethodProvider,0,0,0,0,0,0
System.Web.Mvc,IActionInvoker,0,0,0,0,0,0
System.Web.Mvc,IActionInvokerFactory,0,0,0,0,0,0
System.Web.Http.Controllers,IActionResultConverter,0,0,0,0,0,0
System.Web.Http.Controllers,IActionValueBinder,0,0,0,0,0,0
System.Web.Helpers,IAntiForgeryAdditionalDataProvider,0,0,0,0,0,0
System.Web.Helpers.AntiXsrf,IAntiForgeryConfig,0,0,0,0,0,0
System.Web.Helpers.AntiXsrf,IAntiForgeryTokenSerializer,0,0,0,0,0,0
System.Web.Http.Description,IApiExplorer,0,0,0,0,0,0
System.Web.Http.Dispatcher,IAssembliesResolver,0,0,0,0,0,0
System.Web.WebPages.Razor,IAssemblyBuilder,0,0,0,0,0,0
System.Web.Mvc.Async,IAsyncActionInvoker,0,0,0,0,0,0
System.Web.Mvc.Async,IAsyncActionInvokerFactory,0,0,0,0,0,0
System.Web.Mvc.Async,IAsyncController,0,0,0,0,0,0
System.Web.Mvc.Async,IAsyncManagerContainer,0,0,0,0,0,0
System.Web.Http.Filters,IAuthenticationFilter,0,0,0,0,0,0
System.Web.Http.Filters,IAuthorizationFilter,0,0,0,0,0,0
System.Web.Razor.Generator,IBlockCodeGenerator,0,0,0,0,0,0
System.Web.Http.Validation,IBodyModelValidator,0,0,0,0,0,0
System.Web.Mvc,IBuildManager,0,0,0,0,0,0
System.Web.Http.SelfHost.ServiceModel.Channels,IChannelAcceptor<TChannel>,0,0,0,0,0,0
System.Web.Helpers.AntiXsrf,IClaimUidExtractor,0,0,0,0,0,0
System.Web.Mvc,IClientValidatable,0,0,0,0,0,0
WebMatrix.Data,IConfigurationManager,0,0,0,0,0,0
WebMatrix.Data,IConnectionConfiguration,0,0,0,0,0,0
System.Net.Http.Formatting,IContentNegotiator,0,0,0,0,0,0
System.Web.Mvc,IController,0,0,0,0,0,0
System.Web.Mvc,IControllerActivator,0,0,0,0,0,0
System.Web.Http.Controllers,IControllerConfiguration,0,0,0,0,0,0
System.Web.Mvc,IControllerFactory,0,0,0,0,0,0
System.Web.Cors,ICorsEngine,0,0,0,0,0,0
System.Web.Http.Cors,ICorsPolicyProvider,0,0,0,0,0,0
System.Web.Http.Cors,ICorsPolicyProviderFactory,0,0,0,0,0,0
System.Web.Helpers.AntiXsrf,ICryptoSystem,0,0,0,0,0,0
WebMatrix.WebData,IDatabase,0,0,0,0,0,0
WebMatrix.Data,IDbFileHandler,0,0,0,0,0,0
WebMatrix.Data,IDbProviderFactory,0,0,0,0,0,0
System.Web.Http.Services,IDecorator<T>,0,0,0,0,0,0
System.Web.Http.Dependencies,IDependencyResolver,0,0,0,0,0,0
System.Web.Http.Dependencies,IDependencyScope,0,0,0,0,0,0
System.Web.Http.Routing,IDirectRouteFactory,0,0,0,0,0,0
System.Web.Http.Routing,IDirectRouteProvider,0,0,0,0,0,0
System.Web.WebPages,IDisplayMode,0,0,0,0,0,0
System.Web.Http.Description,IDocumentationProvider,0,0,0,0,0,0
Microsoft.Web.Mvc.Resources,IEnumerableExtensions,0,0,0,0,0,0
Microsoft.Web.Mvc.Resources,IEnumerableExtensions.IEnumerableWrapper<T>,0,0,0,0,0,0
System.Web.Http.ValueProviders,IEnumerableValueProvider,0,0,0,0,0,0
System.Web.Http.Filters,IExceptionFilter,0,0,0,0,0,0
System.Web.Http.ExceptionHandling,IExceptionHandler,0,0,0,0,0,0
System.Web.Http.ExceptionHandling,IExceptionLogger,0,0,0,0,0,0
Microsoft.Web.Mvc.ModelBinding,IExtensibleModelBinder,0,0,0,0,0,0
Microsoft.AspNet.Facebook.Providers,IFacebookClientProvider,0,0,0,0,0,0
Microsoft.AspNet.Facebook.Providers,IFacebookPermissionService,0,0,0,0,0,0
Microsoft.Internal.Web.Utils,IFileSystem,0,0,0,0,0,0
System.Web.Http.Filters,IFilter,0,0,0,0,0,0
System.Web.Http.Filters,IFilterProvider,0,0,0,0,0,0
System.Net.Http.Formatting,IFormatterLogger,0,0,0,0,0,0
System.Web.Http.Tracing,IFormatterTracer,0,0,0,0,0,0
System.Web.Http.Hosting,IHostBufferPolicySelector,0,0,0,0,0,0
System.Web.WebPages.Razor,IHostingEnvironment,0,0,0,0,0,0
System.Web.Http.Controllers,IHttpActionInvoker,0,0,0,0,0,0
System.Web.Http,IHttpActionResult,0,0,0,0,0,0
System.Web.Http.Controllers,IHttpActionSelector,0,0,0,0,0,0
System.Web.Http.Controllers,IHttpController,0,0,0,0,0,0
System.Web.Http.Dispatcher,IHttpControllerActivator,0,0,0,0,0,0
System.Web.Http.Dispatcher,IHttpControllerSelector,0,0,0,0,0,0
System.Web.Http.Dispatcher,IHttpControllerTypeResolver,0,0,0,0,0,0
System.Web.Http.Routing,IHttpRoute,0,0,0,0,0,0
System.Web.Http.Routing,IHttpRouteConstraint,0,0,0,0,0,0
System.Web.Http.Routing,IHttpRouteData,0,0,0,0,0,0
System.Web.Http.Routing,IHttpRouteInfoProvider,0,0,0,0,0,0
System.Web.Http.Routing,IHttpVirtualPathData,0,0,0,0,0,0
System.Web.Http.Routing,IInlineConstraintResolver,0,0,0,0,0,0
Microsoft.Web.Mvc,IMachineKey,0,0,0,0,0,0
Microsoft.Web.Mvc,ImageExtensions,0,0,0,0,0,0
ROOT_PROJECT_NAMESPACE.Areas.HelpPage,ImageSample,0,0,0,0,0,0
System.Web.Mvc,IMetadataAware,0,0,0,0,0,0
System.Web.Mvc,IMethodInfoActionDescriptor,0,0,0,0,0,0
System.Web.Http.ModelBinding,IModelBinder,0,0,0,0,0,0
System.Web.Mvc,IModelBinderProvider,0,0,0,0,0,0
ROOT_PROJECT_NAMESPACE.Areas.HelpPage.ModelDescriptions,IModelDocumentationProvider,0,0,0,0,0,0
System.Web.Http.Validation,IModelValidatorCache,0,0,0,0,0,0
System.Web.Mvc,IMvcControlBuilder,0,0,0,0,0,0
System.Web.Mvc,IMvcFilter,0,0,0,0,0,0
System.Web.Http,IncludeErrorDetailPolicy,0,0,0,0,0,0
Microsoft.Web.Mvc.ExpressionUtil,IndexExpressionFingerprint,0,0,0,0,0,0
System.Web.Mvc,InputType,0,0,0,0,0,0
System.Web.Mvc.Ajax,InsertionMode,0,0,0,0,0,0
System.Web.WebPages.Instrumentation,InstrumentationService,0,0,0,0,0,0
System.Web.Http.Results,InternalServerErrorResult,0,0,0,0,0,0
System.Net.Http.Formatting.Parsers,InternetMessageFormatHeaderParser.CurrentHeaderFieldStore,0,0,0,0,0,0
System.Net.Http.Formatting.Parsers,InternetMessageFormatHeaderParser.HeaderFieldState,0,0,0,0,0,0
System.Web.Http.Routing.Constraints,IntRouteConstraint,0,0,0,0,0,0
System.Net.Http,InvalidByteRangeException,0,0,0,0,0,0
System.Web.Http.Results,InvalidModelStateResult,0,0,0,0,0,0
System.Web.Http.Validation.Providers,InvalidModelValidatorProvider,0,0,0,0,0,0
ROOT_PROJECT_NAMESPACE.Areas.HelpPage,InvalidSample,0,0,0,0,0,0
System.Web.Http.Filters,IOverrideFilter,0,0,0,0,0,0
System.Web.WebPages.Administration.PackageManager,IPackagesSourceFile,0,0,0,0,0,0
Microsoft.Web.Mvc.Resources,IRequestFormatHandler,0,0,0,0,0,0
System.Net.Http.Formatting,IRequiredMemberSelector,0,0,0,0,0,0
System.Web.Mvc,IResolver<T>,0,0,0,0,0,0
System.Web.WebPages.ApplicationParts,IResourceAssembly,0,0,0,0,0,0
Microsoft.Web.Mvc.Resources,IResponseFormatHandler,0,0,0,0,0,0
System.Web.Mvc,IResultFilter,0,0,0,0,0,0
System.Web.Mvc.Routing,IRouteInfoProvider,0,0,0,0,0,0
System.Web.Http.Routing,IRoutePrefix,0,0,0,0,0,0
System.Web.Mvc,IRouteWithArea,0,0,0,0,0,0
System.Web.WebPages.Scope,IScopeStorageProvider,0,0,0,0,0,0
System.Web.Razor.Generator,ISpanCodeGenerator,0,0,0,0,0,0
System.Web.Razor.Tokenizer.Symbols,ISymbol,0,0,0,0,0,0
System.Web.Razor.Parser,ISyntaxTreeRewriter,0,0,0,0,0,0
System.Web.Mvc,ITempDataProvider,0,0,0,0,0,0
System.Web.Mvc,ITempDataProviderFactory,0,0,0,0,0,0
System.Web.WebPages,ITemplateFile,0,0,0,0,0,0
System.Web.Razor.Text,ITextBuffer,0,0,0,0,0,0
System.Web.Razor.Text,ITextDocument,0,0,0,0,0,0
System.Web.Razor.Tokenizer,ITokenizer,0,0,0,0,0,0
System.Web.Helpers.AntiXsrf,ITokenStore,0,0,0,0,0,0
System.Web.Helpers.AntiXsrf,ITokenValidator,0,0,0,0,0,0
System.Web.Http.Tracing,ITraceManager,0,0,0,0,0,0
System.Web.Http.Tracing,ITraceWriter,0,0,0,0,0,0
System.Web.Mvc,IUniquelyIdentifiable,0,0,0,0,0,0
System.Web.Mvc,IUnvalidatedRequestValues,0,0,0,0,0,0
System.Web.Mvc,IUnvalidatedValueProvider,0,0,0,0,0,0
System.Web.Http.ValueProviders,IUriValueProviderFactory,0,0,0,0,0,0
System.Web.WebPages,IValidator,0,0,0,0,0,0
System.Web.Http.ValueProviders,IValueProvider,0,0,0,0,0,0
System.Web.Http.ModelBinding,IValueProviderParameterBinding,0,0,0,0,0,0
System.Web.Mvc,IView,0,0,0,0,0,0
System.Web.Mvc,IViewDataContainer,0,0,0,0,0,0
System.Web.Mvc,IViewEngine,0,0,0,0,0,0
System.Web.Mvc,IViewLocationCache,0,0,0,0,0,0
System.Web.Mvc,IViewPageActivator,0,0,0,0,0,0
System.Web.Mvc,IViewStartPageChild,0,0,0,0,0,0
System.Web.WebPages,IVirtualPathFactory,0,0,0,0,0,0
Microsoft.Internal.Web.Utils,IVirtualPathUtility,0,0,0,0,0,0
System.Web.Helpers,IWebGridDataSource,0,0,0,0,0,0
System.Web.WebPages,IWebPageRequestExecutor,0,0,0,0,0,0
System.Web.WebPages.Administration.PackageManager,IWebProjectManager,0,0,0,0,0,0
Microsoft.AspNet.Facebook,JavaScriptRedirectResult,0,0,0,0,0,0
System.Web.Mvc,JavaScriptResult,0,0,0,0,0,0
System.Web.Mvc,JQueryFormValueProvider,0,0,0,0,0,0
System.Web.Mvc,JQueryFormValueProviderFactory,0,0,0,0,0,0
System.Web.Http.ModelBinding,JQueryMvcFormUrlEncodedFormatter,0,0,0,0,0,0
System.Web.Helpers,Json,0,0,0,0,0,0
System.Net.Http.Formatting,JsonContractResolver,0,0,0,0,0,0
Microsoft.Web.Mvc.Resources,JsonFormatHandler,0,0,0,0,0,0
System.Web.Mvc,JsonRequestBehavior,0,0,0,0,0,0
System.Web.Mvc,JsonResult,0,0,0,0,0,0
System.Web.Http.Results,JsonResult<T>,0,0,0,0,0,0
System.Web.Mvc,JsonValueProviderFactory,0,0,0,0,0,0
System.Web.Mvc,JsonValueProviderFactory.EntryLimitedDictionary,0,0,0,0,0,0
 ,Justifications,0,0,0,0,0,0
Microsoft.Web.Mvc.ModelBinding,"KeyValuePairModelBinder<TKey, TValue>",0,0,0,0,0,0
Microsoft.Web.Mvc.ModelBinding,KeyValuePairModelBinderProvider,0,0,0,0,0,0
Microsoft.Web.Mvc.ModelBinding,KeyValuePairModelBinderUtil,0,0,0,0,0,0
ROOT_PROJECT_NAMESPACE.Areas.HelpPage.ModelDescriptions,KeyValuePairModelDescription,0,0,0,0,0,0
System.Web.Razor.Tokenizer.Symbols,KnownSymbolType,0,0,0,0,0,0
Microsoft.Web.Mvc.Controls,Label,0,0,0,0,0,0
Microsoft.Web.Mvc.ExpressionUtil,LambdaExpressionFingerprint,0,0,0,0,0,0
System.Web.Razor.Parser,"LanguageCharacteristics<TTokenizer, TSymbol, TSymbolType>",0,0,0,0,0,0
System.Web.Http.ExceptionHandling,LastChanceExceptionHandler,0,0,0,0,0,0
System.Web.Http.SelfHost.ServiceModel.Channels,LayeredChannel<TInnerChannel>,0,0,0,0,0,0
System.Web.Http.SelfHost.ServiceModel.Channels,"LayeredChannelAcceptor<TChannel, TInnerChannel>",0,0,0,0,0,0
System.Web.Http.SelfHost.ServiceModel.Channels,LayeredChannelListener<TChannel>.CloseAsyncResult,0,0,0,0,0,0
System.Web.Http.SelfHost.ServiceModel.Channels,LayeredChannelListener<TChannel>.OpenAsyncResult,0,0,0,0,0,0
System.Web.WebPages.ApplicationParts,LazyAction,0,0,0,0,0,0
System.Web.Http.Routing.Constraints,LengthRouteConstraint,0,0,0,0,0,0
System.Web.Razor.Text,LineTrackingStringBuffer,0,0,0,0,0,0
System.Web.Razor.Text,LineTrackingStringBuffer.CharacterReference,0,0,0,0,0,0
System.Web.Razor.Text,LineTrackingStringBuffer.TextLine,0,0,0,0,0,0
Microsoft.Web.Mvc,LinkBuilder,0,0,0,0,0,0
System.Web.Http.Routing,LinkGenerationRoute,0,0,0,0,0,0
Microsoft.Web.Helpers,LinkShareSite,0,0,0,0,0,0
System.Web.Mvc,LinqBinaryModelBinder,0,0,0,0,0,0
System.Collections.ObjectModel,ListWrapperCollection<T>,0,0,0,0,0,0
System.Web.Razor.Text,LocationTagged<T>,0,0,0,0,0,0
System.Web.Http.Routing.Constraints,LongRouteConstraint,0,0,0,0,0,0
System.Web.Razor.Text,LookaheadTextReader,0,0,0,0,0,0
System.Web.Razor.Text,LookaheadToken,0,0,0,0,0,0
System.Web.Helpers.AntiXsrf,MachineKey45CryptoSystem,0,0,0,0,0,0
Microsoft.Web.Mvc,MachineKeyWrapper,0,0,0,0,0,0
Microsoft.Web.Mvc,MailToExtensions,0,0,0,0,0,0
System.Web.Razor.Generator,MarkupCodeGenerator,0,0,0,0,0,0
System.Web.Razor.Parser,MarkupCollapser,0,0,0,0,0,0
System.Web.Razor.Parser,MarkupRewriter,0,0,0,0,0,0
System.Web.Http.Routing.Constraints,MaxLengthRouteConstraint,0,0,0,0,0,0
System.Web.Http.Routing.Constraints,MaxRouteConstraint,0,0,0,0,0,0
System.Net.Http.Formatting,MediaTypeConstants,0,0,0,0,0,0
System.Net.Http.Formatting,MediaTypeFormatter.MediaTypeHeaderValueCollection,0,0,0,0,0,0
System.Net.Http.Formatting,MediaTypeFormatterExtensions,0,0,0,0,0,0
System.Net.Http.Formatting,MediaTypeFormatterMatch,0,0,0,0,0,0
System.Net.Http.Formatting,MediaTypeFormatterMatchRanking,0,0,0,0,0,0
System.Net.Http.Formatting,MediaTypeHeaderValueExtensions,0,0,0,0,0,0
System.Net.Http.Formatting,MediaTypeHeaderValueRange,0,0,0,0,0,0
System.Net.Http.Formatting,MediaTypeMapping,0,0,0,0,0,0
System.Net.Http.Formatting,MediaTypeWithQualityHeaderValueComparer,0,0,0,0,0,0
Microsoft.Web.Mvc.ExpressionUtil,MemberExpressionFingerprint,0,0,0,0,0,0
System.Web.Http.Internal,MemberInfoExtensions,0,0,0,0,0,0
System.Web.Http.Tracing.Tracers,MessageHandlerTracer,0,0,0,0,0,0
Microsoft.Web.Mvc.ExpressionUtil,MethodCallExpressionFingerprint,0,0,0,0,0,0
System.Net.Http,MimeBodyPart,0,0,0,0,0,0
Microsoft.Internal.Web.Utils,MimeMapping,0,0,0,0,0,0
System.Net.Http.Formatting.Parsers,MimeMultipartBodyPartParser,0,0,0,0,0,0
System.Net.Http.Formatting.Parsers,MimeMultipartParser.BodyPartState,0,0,0,0,0,0
System.Net.Http.Formatting.Parsers,MimeMultipartParser.CurrentBodyPartStore,0,0,0,0,0,0
System.Net.Http.Formatting.Parsers,MimeMultipartParser.MessageState,0,0,0,0,0,0
System.Net.Http.Formatting.Parsers,MimeMultipartParser.State,0,0,0,0,0,0
System.Web.Http.Routing.Constraints,MinLengthRouteConstraint,0,0,0,0,0,0
System.Web.Http.Routing.Constraints,MinRouteConstraint,0,0,0,0,0,0
System.Web.Http.ModelBinding,ModelBinderAttribute,0,0,0,0,0,0
Microsoft.Web.Mvc.ModelBinding,ModelBinderErrorMessageProvider,0,0,0,0,0,0
System.Web.Http.ModelBinding,ModelBinderParameterBinding,0,0,0,0,0,0
Microsoft.Web.Mvc.ModelBinding,ModelBinderProvider,0,0,0,0,0,0
Microsoft.Web.Mvc.ModelBinding,ModelBinderProviderOptionsAttribute,0,0,0,0,0,0
Microsoft.Web.Mvc.ModelBinding,ModelBinderProviders,0,0,0,0,0,0
System.Web.Mvc,ModelBinders,0,0,0,0,0,0
Microsoft.Web.Mvc.ModelBinding,ModelBinderUtil,0,0,0,0,0,0
System.Web.Mvc,ModelBindingContext.UnvalidatedValueProviderWrapper,0,0,0,0,0,0
System.Web.Http.ModelBinding,ModelBindingHelper,0,0,0,0,0,0
System.Web.Mvc,ModelClientValidationEqualToRule,0,0,0,0,0,0
System.Web.Mvc,ModelClientValidationMaxLengthRule,0,0,0,0,0,0
System.Web.Mvc,ModelClientValidationMembershipPasswordRule,0,0,0,0,0,0
System.Web.Mvc,ModelClientValidationMinLengthRule,0,0,0,0,0,0
System.Web.Mvc,ModelClientValidationRangeRule,0,0,0,0,0,0
System.Web.Mvc,ModelClientValidationRegexRule,0,0,0,0,0,0
System.Web.Mvc,ModelClientValidationRemoteRule,0,0,0,0,0,0
System.Web.Mvc,ModelClientValidationRequiredRule,0,0,0,0,0,0
System.Web.Mvc,ModelClientValidationRule,0,0,0,0,0,0
System.Web.Mvc,ModelClientValidationStringLengthRule,0,0,0,0,0,0
Microsoft.Web.Mvc,ModelCopier,0,0,0,0,0,0
ROOT_PROJECT_NAMESPACE.Areas.HelpPage.ModelDescriptions,ModelDescription,0,0,0,0,0,0
System.Web.Http.ModelBinding,ModelError,0,0,0,0,0,0
System.Web.Http.ModelBinding,ModelErrorCollection,0,0,0,0,0,0
System.Web.Http.Metadata,ModelMetadataProvider,0,0,0,0,0,0
System.Web.Mvc,ModelMetadataProviders,0,0,0,0,0,0
ROOT_PROJECT_NAMESPACE.Areas.HelpPage.ModelDescriptions,ModelNameAttribute,0,0,0,0,0,0
ROOT_PROJECT_NAMESPACE.Areas.HelpPage.ModelDescriptions,ModelNameHelper,0,0,0,0,0,0
System.Web.Http.ModelBinding,ModelState,0,0,0,0,0,0
System.Web.Http.Validation,ModelStateFormatterLogger,0,0,0,0,0,0
Microsoft.Web.Mvc.ModelBinding,ModelValidatedEventArgs,0,0,0,0,0,0
Microsoft.Web.Mvc.ModelBinding,ModelValidatingEventArgs,0,0,0,0,0,0
System.Web.Http.Validation,ModelValidationRequiredMemberSelector,0,0,0,0,0,0
System.Web.Http.Validation,ModelValidationResult,0,0,0,0,0,0
System.Web.Http.Validation,ModelValidator,0,0,0,0,0,0
System.Web.Http.Validation,ModelValidator.CompositeModelValidator,0,0,0,0,0,0
System.Web.Http.Validation,ModelValidatorCache,0,0,0,0,0,0
System.Web.Http.Validation,ModelValidatorProvider,0,0,0,0,0,0
System.Web.Mvc,ModelValidatorProviderCollection,0,0,0,0,0,0
System.Web.Mvc,ModelValidatorProviders,0,0,0,0,0,0
Microsoft.Web.Mvc.Resources,MultiFormatActionResult,0,0,0,0,0,0
System.Net.Http,MultipartFileData,0,0,0,0,0,0
System.Net.Http,MultipartFileStreamProvider,0,0,0,0,0,0
System.Net.Http,MultipartFormDataRemoteStreamProvider,0,0,0,0,0,0
System.Net.Http,MultipartFormDataStreamProvider,0,0,0,0,0,0
System.Net.Http,MultipartFormDataStreamProviderHelper,0,0,0,0,0,0
System.Net.Http,MultipartMemoryStreamProvider,0,0,0,0,0,0
System.Net.Http,MultipartRelatedStreamProvider,0,0,0,0,0,0
System.Net.Http,MultipartRemoteFileData,0,0,0,0,0,0
System.Net.Http,MultipartStreamProvider,0,0,0,0,0,0
System.Web.Mvc,MultiServiceResolver,0,0,0,0,0,0
Microsoft.Web.Mvc.ModelBinding,MutableObjectModelBinderProvider,0,0,0,0,0,0
Microsoft.Web.Mvc.Controls,MvcControl,0,0,0,0,0,0
System.Web.Mvc,MvcFilter,0,0,0,0,0,0
System.Web.Mvc.Html,MvcForm,0,0,0,0,0,0
System.Web.Mvc,MvcHandler.ProcessRequestState,0,0,0,0,0,0
System.Web.Mvc,MvcHtmlString,0,0,0,0,0,0
System.Web.Mvc,MvcHttpHandler,0,0,0,0,0,0
System.Web.Mvc,MvcHttpHandler.DummyHttpHandler,0,0,0,0,0,0
System.Web.Mvc,MvcRouteHandler,0,0,0,0,0,0
Microsoft.Web.Mvc,MvcSerializer,0,0,0,0,0,0
System.Web.Mvc.Razor,MvcWebPageRazorHost,0,0,0,0,0,0
System.Web.Mvc,MvcWebRazorHostFactory,0,0,0,0,0,0
System.Web.Mvc.Html,NameExtensions,0,0,0,0,0,0
System.Web.Mvc,NameValueCollectionExtensions,0,0,0,0,0,0
System.Web.Mvc,NameValueCollectionValueProvider,0,0,0,0,0,0
System.Web.Mvc,NameValueCollectionValueProvider.ValueProviderResultPlaceholder,0,0,0,0,0,0
System.Web.Http.ValueProviders.Providers,NameValuePairsValueProvider,0,0,0,0,0,0
System.Web.Http.Results,NegotiatedContentResult<T>,0,0,0,0,0,0
System.Web.Http.Results,NegotiatedContentResult<T>.ApiControllerDependencyProvider,0,0,0,0,0,0
System.Web.Http.Results,NegotiatedContentResult<T>.DirectDependencyProvider,0,0,0,0,0,0
System.Web.Http.Results,NegotiatedContentResult<T>.IDependencyProvider,0,0,0,0,0,0
System.Web.Http,NonActionAttribute,0,0,0,0,0,0
System.Web.Http.Results,NotFoundResult,0,0,0,0,0,0
System.Web.Mvc,NullViewLocationCache,0,0,0,0,0,0
Microsoft.Web.WebPages.OAuth,OAuthAccount,0,0,0,0,0,0
WebMatrix.WebData,OAuthAccountData,0,0,0,0,0,0
System.Net.Http,ObjectContent,0,0,0,0,0,0
System.Net.Http,ObjectContent<T>,0,0,0,0,0,0
System.Web.Helpers,ObjectInfo,0,0,0,0,0,0
System.Web.Helpers,ObjectVisitor.ObjectVisitorException,0,0,0,0,0,0
System.Web.Http.Results,OkNegotiatedContentResult<T>,0,0,0,0,0,0
System.Web.Http.Results,OkResult,0,0,0,0,0,0
System.Web.Mvc.Async,OperationCounter,0,0,0,0,0,0
System.Web.Http.Routing.Constraints,OptionalRouteConstraint,0,0,0,0,0,0
System.Web.Http,OverrideActionFiltersAttribute,0,0,0,0,0,0
System.Web.Http,OverrideAuthenticationAttribute,0,0,0,0,0,0
System.Web.Http,OverrideAuthorizationAttribute,0,0,0,0,0,0
System.Web.Http,OverrideExceptionFiltersAttribute,0,0,0,0,0,0
System.Web.Http.Tracing.Tracers,OverrideFilterTracer,0,0,0,0,0,0
System.Web.Mvc,OverrideResultFiltersAttribute,0,0,0,0,0,0
System.Web.Http.Owin,OwinBufferPolicySelector,0,0,0,0,0,0
System.Web.Http.Owin,OwinConstants,0,0,0,0,0,0
System.Web.Http.Owin,OwinExceptionCatchBlocks,0,0,0,0,0,0
System.Web.Http,OwinHttpConfigurationExtensions,0,0,0,0,0,0
System.Web.Http.Owin,OwinHttpRequestContext,0,0,0,0,0,0
System.Net.Http,OwinHttpRequestMessageExtensions,0,0,0,0,0,0
System.Web.Http.Owin,OwinRequestExtensions,0,0,0,0,0,0
System.Web.Http.Owin,OwinResponseExtensions,0,0,0,0,0,0
System.Web.WebPages.Administration.PackageManager,PackageExtensions,0,0,0,0,0,0
System.Web.WebPages.Administration.PackageManager,PackageManagerModule,0,0,0,0,0,0
System.Web.WebPages.Administration.PackageManager,PackageSourceFile,0,0,0,0,0,0
System.Web.WebPages,PageDataDictionary<TValue>.PageDataComparer,0,0,0,0,0,0
System.Web.WebPages.Instrumentation,PageInstrumentationServiceAdapter,0,0,0,0,0,0
System.Web.WebPages.Instrumentation,PageInstrumentationServiceAdapter._CallSite_ctor_2,0,0,0,0,0,0
System.Web.WebPages.Instrumentation,PageInstrumentationServiceAdapter._CallSite_IsEnabled_1,0,0,0,0,0,0
System.Web.WebPages.Administration.PackageManager,PageUtils,0,0,0,0,0,0
System.Web.WebPages,PageVirtualPathAttribute,0,0,0,0,0,0
ROOT_PROJECT_NAMESPACE.Areas.HelpPage.ModelDescriptions,ParameterAnnotation,0,0,0,0,0,0
System.Web.Http,ParameterBindingAttribute,0,0,0,0,0,0
System.Web.Http.Controllers,ParameterBindingExtensions,0,0,0,0,0,0
System.Web.Mvc,ParameterBindingInfo,0,0,0,0,0,0
System.Web.Http.ModelBinding,ParameterBindingRulesCollection,0,0,0,0,0,0
ROOT_PROJECT_NAMESPACE.Areas.HelpPage.ModelDescriptions,ParameterDescription,0,0,0,0,0,0
System.Web.Mvc,ParameterDescriptor,0,0,0,0,0,0
System.Web.Mvc,ParameterDescriptor.EmptyParameterBindingInfo,0,0,0,0,0,0
Microsoft.Web.Mvc.ExpressionUtil,ParameterExpressionFingerprint,0,0,0,0,0,0
System.Web.Http.Internal,ParameterInfoExtensions,0,0,0,0,0,0
System.Web.Mvc,ParameterInfoUtil,0,0,0,0,0,0
System.Net.Http.Formatting,ParsedMediaTypeHeaderValue,0,0,0,0,0,0
System.Web.Mvc.Routing,ParsedRoute,0,0,0,0,0,0
System.Web.Razor.Parser,ParserBase,0,0,0,0,0,0
System.Web.Razor.Parser,ParserHelpers,0,0,0,0,0,0
System.Web.Razor,ParserResults,0,0,0,0,0,0
System.Net.Http.Formatting.Parsers,ParserState,0,0,0,0,0,0
System.Web.Razor.Parser,ParserVisitor,0,0,0,0,0,0
System.Web.Razor.Parser,ParserVisitorExtensions,0,0,0,0,0,0
System.Web.Mvc.Html,PartialExtensions,0,0,0,0,0,0
System.Web.Razor,PartialParseResult,0,0,0,0,0,0
System.Web.Mvc,PartialViewResult,0,0,0,0,0,0
System.Web.Http.Owin,PassiveAuthenticationMessageHandler,0,0,0,0,0,0
System.Web.Http.Routing,PathContentSegment,0,0,0,0,0,0
System.Web,PathHelpers,0,0,0,0,0,0
System.Web.Http.Routing,PathLiteralSubsegment,0,0,0,0,0,0
System.Web.Http.Routing,PathParameterSubsegment,0,0,0,0,0,0
System.Web.Http.Routing,PathSegment,0,0,0,0,0,0
System.Web.Http.Routing,PathSeparatorSegment,0,0,0,0,0,0
System.Web.Http.Routing,PathSubsegment,0,0,0,0,0,0
System.Web.WebPages,PathUtil,0,0,0,0,0,0
Microsoft.AspNet.Facebook,PermissionContext,0,0,0,0,0,0
Microsoft.AspNet.Facebook,PermissionHelper,0,0,0,0,0,0
Microsoft.AspNet.Facebook,PermissionsStatus,0,0,0,0,0,0
Microsoft.AspNet.Facebook,PermissionStatus,0,0,0,0,0,0
Microsoft.Internal.Web.Utils,PhysicalFileSystem,0,0,0,0,0,0
System.Web.WebPages.Instrumentation,PositionTagged<T>,0,0,0,0,0,0
System.Web.Helpers,PreComputedGridDataSource,0,0,0,0,0,0
System.Web,PrefixContainer.PrefixComparer,0,0,0,0,0,0
System.Net.Http.Handlers,ProgressContent,0,0,0,0,0,0
System.Net.Http.Handlers,ProgressMessageHandler,0,0,0,0,0,0
System.Net.Http.Handlers,ProgressWriteAsyncResult,0,0,0,0,0,0
System.Web.Http.Internal,"PropertyHelper.ByRefFunc<TDeclaringType, TValue>",0,0,0,0,0,0
Microsoft.Web.WebPages.OAuth,ProviderUserIdSerializationHelper,0,0,0,0,0,0
System.Net.Http,PushStreamContent,0,0,0,0,0,0
System.Net.Http.Formatting,QueryStringMapping,0,0,0,0,0,0
System.Web.Http.ValueProviders.Providers,QueryStringValueProvider,0,0,0,0,0,0
System.Web.Http.ValueProviders.Providers,QueryStringValueProviderFactory,0,0,0,0,0,0
Microsoft.Web.Mvc,RadioListExtensions,0,0,0,0,0,0
System.Web.Http.Routing.Constraints,RangeRouteConstraint,0,0,0,0,0,0
System.Web.Razor.Generator,RazorCodeGenerator,0,0,0,0,0,0
System.Web.Razor,RazorCodeLanguage,0,0,0,0,0,0
System.Web.Razor.Generator,RazorCommentCodeGenerator,0,0,0,0,0,0
System.Web.Razor,RazorDebugHelpers,0,0,0,0,0,0
System.Web.Razor,RazorDirectiveAttribute,0,0,0,0,0,0
System.Web.Razor.Generator,RazorDirectiveAttributeCodeGenerator,0,0,0,0,0,0
System.Web.Razor,RazorEditorParser,0,0,0,0,0,0
System.Web.Razor.Editor,RazorEditorTrace,0,0,0,0,0,0
System.Web.Razor.Parser.SyntaxTree,RazorError,0,0,0,0,0,0
System.Web.WebPages.Razor.Configuration,RazorPagesSection,0,0,0,0,0,0
System.Web.Razor,RazorTemplateEngine,0,0,0,0,0,0
System.Web.Mvc,RazorView,0,0,0,0,0,0
System.Web.Mvc,RazorViewEngine,0,0,0,0,0,0
System.Web.WebPages.Razor.Configuration,RazorWebSectionGroup,0,0,0,0,0,0
Microsoft.Web.Mvc,"ReaderWriterCache<TKey, TValue>",0,0,0,0,0,0
System.Net.Http.Internal,ReadOnlyStreamWithEncodingPreamble,0,0,0,0,0,0
System.Web.Http.Results,RedirectResult,0,0,0,0,0,0
System.Web.Http.Results,RedirectToRouteResult.ApiControllerDependencyProvider,0,0,0,0,0,0
System.Web.Http.Results,RedirectToRouteResult.DirectDependencyProvider,0,0,0,0,0,0
System.Web.Http.Results,RedirectToRouteResult.IDependencyProvider,0,0,0,0,0,0
System.Web.Http.Validation,ReferenceEqualityComparer,0,0,0,0,0,0
System.Web.Mvc,ReflectedActionDescriptor,0,0,0,0,0,0
System.Web.Mvc.Async,ReflectedAsyncControllerDescriptor,0,0,0,0,0,0
System.Web.Mvc,ReflectedAttributeCache,0,0,0,0,0,0
System.Web.Mvc,"ReflectedAttributeCache.CachedDelegates<TMemberInfo, TAttribute>",0,0,0,0,0,0
System.Web.Mvc,ReflectedControllerDescriptor,0,0,0,0,0,0
System.Web.Http.Controllers,ReflectedHttpParameterDescriptor,0,0,0,0,0,0
System.Web.Mvc,ReflectedParameterBindingInfo,0,0,0,0,0,0
System.Web.Mvc,ReflectedParameterDescriptor,0,0,0,0,0,0
System.Web.WebPages,ReflectionDynamicObject,0,0,0,0,0,0
System.Web.Http.Routing.Constraints,RegexRouteConstraint,0,0,0,0,0,0
System.Web.Mvc,RemoteAttribute,0,0,0,0,0,0
System.Net.Http,RemoteStreamInfo,0,0,0,0,0,0
System.Web.Mvc.Html,RenderPartialExtensions,0,0,0,0,0,0
Microsoft.Web.Mvc.Controls,Repeater,0,0,0,0,0,0
Microsoft.Web.Mvc.Controls,RepeaterItem,0,0,0,0,0,0
System.Web.Http.Controllers,RequestBackedHttpRequestContext,0,0,0,0,0,0
System.Web.WebPages,RequestBrowserOverrideStore,0,0,0,0,0,0
Microsoft.Web.Mvc.Resources,RequestContextExtensions,0,0,0,0,0,0
System.Web.WebPages,RequestExtensions,0,0,0,0,0,0
System.Web.WebPages,RequestFieldValidatorBase,0,0,0,0,0,0
System.Net.Http.Formatting,RequestHeaderMapping,0,0,0,0,0,0
System.Web.Http.Tracing.Tracers,RequestMessageHandlerTracer,0,0,0,0,0,0
System.Web.WebPages,RequestResourceTracker,0,0,0,0,0,0
System.Web.WebPages,RequestResourceTracker.SecureWeakReference,0,0,0,0,0,0
System.Web.Http.Validation.Validators,RequiredMemberModelValidator,0,0,0,0,0,0
System.Web.Http.Validation.Providers,RequiredMemberModelValidatorProvider,0,0,0,0,0,0
System.Web.Mvc,RequireHttpsAttribute,0,0,0,0,0,0
System.Web.WebPages.ApplicationParts,ResourceAssembly,0,0,0,0,0,0
Microsoft.Web.Mvc.Resources,ResourceControllerFactory,0,0,0,0,0,0
Microsoft.Web.Mvc.Resources,ResourceControllerFactory.ResourceControllerActionInvoker,0,0,0,0,0,0
Microsoft.Web.Mvc.Resources,ResourceControllerFactory.ResourceControllerActionInvoker.ResourceErrorActionDescriptor,0,0,0,0,0,0
Microsoft.Web.Mvc.Resources,ResourceErrorActionResult,0,0,0,0,0,0
System.Web.WebPages.ApplicationParts,ResourceHandler,0,0,0,0,0,0
Microsoft.Web.Mvc.Resources,ResourceModelBinder,0,0,0,0,0,0
Microsoft.Web.Mvc.Resources,ResourceModelBinder.MyDefaultModelBinder,0,0,0,0,0,0
Microsoft.Web.Mvc.Resources,ResourceRedirectToRouteResult,0,0,0,0,0,0
System.Web.WebPages.ApplicationParts,ResourceRouteHandler,0,0,0,0,0,0
System.Web.Http.Description,ResponseDescription,0,0,0,0,0,0
System.Web.WebPages,ResponseExtensions,0,0,0,0,0,0
System.Web.Http.Results,ResponseMessageResult,0,0,0,0,0,0
System.Web.Http.Controllers,ResponseMessageResultConverter,0,0,0,0,0,0
System.Web.Http.Description,ResponseTypeAttribute,0,0,0,0,0,0
System.Web.Mvc,ResultExecutedContext,0,0,0,0,0,0
System.Web.Mvc,ResultExecutingContext,0,0,0,0,0,0
System.Web.Mvc,RouteAreaAttribute,0,0,0,0,0,0
System.Web.Http,RouteAttribute,0,0,0,0,0,0
System.Web.Mvc.Routing,RouteBuilder,0,0,0,0,0,0
System.Web.Mvc,RouteCollectionAttributeRoutingExtensions,0,0,0,0,0,0
System.Web.Mvc,RouteCollectionExtensions.IgnoreRouteInternal,0,0,0,0,0,0
System.Web.Http.Routing,RouteCollectionRoute.RouteCollectionRouteData,0,0,0,0,0,0
System.Web.Http.Routing,RouteDataTokenKeys,0,0,0,0,0,0
System.Web.Http.ValueProviders.Providers,RouteDataValueProvider,0,0,0,0,0,0
System.Web.Http.ValueProviders.Providers,RouteDataValueProviderFactory,0,0,0,0,0,0
System.Web.Http.Routing,RouteEntry,0,0,0,0,0,0
System.Web.Http.Routing,RouteInfoDirectRouteFactory,0,0,0,0,0,0
System.Web.Http,RouteParameter,0,0,0,0,0,0
System.Web.Http.Routing,RoutePrecedence,0,0,0,0,0,0
System.Web.Http,RoutePrefixAttribute,0,0,0,0,0,0
System.Web.Http.Routing,RouteValueKeys,0,0,0,0,0,0
Microsoft.Web.Mvc.Controls,RouteValues,0,0,0,0,0,0
System.Web.Mvc,RouteValuesHelpers,0,0,0,0,0,0
System.Web.Http.Routing,RoutingContext,0,0,0,0,0,0
ROOT_PROJECT_NAMESPACE.Areas.HelpPage,SampleDirection,0,0,0,0,0,0
System.Web.WebPages.Scope,ScopeStorage,0,0,0,0,0,0
System.Web.WebPages.Scope,ScopeStorageComparer,0,0,0,0,0,0
System.Web.WebPages.Scope,ScopeStorageDictionary.StateStorageKeyValueComparer,0,0,0,0,0,0
Microsoft.Web.Mvc,ScriptExtensions,0,0,0,0,0,0
System.Web.Razor.Generator,SectionCodeGenerator,0,0,0,0,0,0
System.Web.WebPages,SectionWriter,0,0,0,0,0,0
System.Web.Razor.Text,SeekableTextReader,0,0,0,0,0,0
System.Web.Mvc,SelectList,0,0,0,0,0,0
System.Web.Mvc,SelectListGroup,0,0,0,0,0,0
System.Web.Mvc,SelectListItem,0,0,0,0,0,0
System.Web.Http.SelfHost,SelfHostHttpRequestContext,0,0,0,0,0,0
Microsoft.Web.Mvc,SerializationExtensions,0,0,0,0,0,0
Microsoft.Web.Mvc,ServerVariablesValueProviderFactory,0,0,0,0,0,0
System.Web.Mvc,SessionStateAttribute,0,0,0,0,0,0
System.Web.Mvc,SessionStateTempDataProvider,0,0,0,0,0,0
System.Web.WebPages,SessionStateUtil,0,0,0,0,0,0
Microsoft.Web.Mvc,SessionValueProviderFactory,0,0,0,0,0,0
System.Web.Razor.Generator,SetBaseTypeCodeGenerator,0,0,0,0,0,0
System.Web.Razor.Generator,SetLayoutCodeGenerator,0,0,0,0,0,0
System.Web.Mvc.Razor,SetModelTypeCodeGenerator,0,0,0,0,0,0
System.Web.Razor.Generator,SetVBOptionCodeGenerator,0,0,0,0,0,0
System.Web.Mvc.Async,SimpleAsyncResult,0,0,0,0,0,0
WebMatrix.WebData,SimpleMembershipProviderCasingBehavior,0,0,0,0,0,0
Microsoft.Web.Mvc.ModelBinding,SimpleModelBinderProvider,0,0,0,0,0,0
System.Web.Http.ModelBinding.Binders,SimpleModelBinderProvider.SimpleModelBinder,0,0,0,0,0,0
ROOT_PROJECT_NAMESPACE.Areas.HelpPage.ModelDescriptions,SimpleTypeModelDescription,0,0,0,0,0,0
System.Web.Mvc.Async,SingleEntryGate,0,0,0,0,0,0
System.Web.Razor.Editor,SingleLineMarkupEditHandler,0,0,0,0,0,0
System.Web.Http,SingleResult,0,0,0,0,0,0
System.Web.Http,SingleResult<T>,0,0,0,0,0,0
System.Web.Mvc,SingleServiceResolver<TService>,0,0,0,0,0,0
Microsoft.Web.Mvc,SkipBindingAttribute,0,0,0,0,0,0
Microsoft.Web.Mvc,SkipBindingAttribute.NullBinder,0,0,0,0,0,0
System.Web.Helpers,SortDirection,0,0,0,0,0,0
System.Web.Helpers,SortInfo,0,0,0,0,0,0
System.Web.Razor.Text,SourceLocation,0,0,0,0,0,0
System.Web.Razor.Text,SourceLocationTracker,0,0,0,0,0,0
System.Web.Razor.Parser.SyntaxTree,SpanBuilder,0,0,0,0,0,0
System.Web.Razor.Generator,SpanCodeGenerator,0,0,0,0,0,0
System.Web.Razor.Generator,SpanCodeGenerator.NullSpanCodeGenerator,0,0,0,0,0,0
System.Web.Razor.Parser.SyntaxTree,SpanKind,0,0,0,0,0,0
WebMatrix.Data,SqlCeDbFileHandler,0,0,0,0,0,0
WebMatrix.Data,SqlServerDbFileHandler,0,0,0,0,0,0
System.Web.WebPages,StartPage,0,0,0,0,0,0
System.Web.Mvc.Razor,StartPageLookupDelegate,0,0,0,0,0,0
System.Web.Razor,StateMachine<TReturn>,0,0,0,0,0,0
System.Web.Razor,StateMachine<TReturn>.State,0,0,0,0,0,0
System.Web.Razor,StateMachine<TReturn>.StateResult,0,0,0,0,0,0
System.Web.Razor.Generator,StatementCodeGenerator,0,0,0,0,0,0
System.Web.WebPages.Scope,StaticScopeStorageProvider,0,0,0,0,0,0
System.Web.Http.Results,StatusCodeResult,0,0,0,0,0,0
System.Web.Http.Results,StatusCodeResult.ApiControllerDependencyProvider,0,0,0,0,0,0
System.Web.Http.Results,StatusCodeResult.DirectDependencyProvider,0,0,0,0,0,0
System.Web.Http.Results,StatusCodeResult.IDependencyProvider,0,0,0,0,0,0
System.Web.Http.Routing,StopRoutingHandler,0,0,0,0,0,0
System.Net.Http.Formatting,StringComparisonHelper,0,0,0,0,0,0
System.Web.WebPages,StringExtensions,0,0,0,0,0,0
System.Net.Http.Formatting,StringWithQualityHeaderValueComparer,0,0,0,0,0,0
System.Web.WebPages,StringWriterExtensions,0,0,0,0,0,0
System.Web.Http.Routing,SubRouteCollection,0,0,0,0,0,0
Microsoft.AspNet.Facebook.Models,SubscriptionVerification,0,0,0,0,0,0
System.Web.Http.WebHost,SuppressFormsAuthRedirectHelper,0,0,0,0,0,0
System.Web.Http.Hosting,SuppressHostPrincipalMessageHandler,0,0,0,0,0,0
System.Web.Razor.Tokenizer.Symbols,SymbolBase<TType>,0,0,0,0,0,0
System.Web.Razor.Tokenizer.Symbols,SymbolExtensions,0,0,0,0,0,0
System.Web.Mvc.Async,SynchronizationContextUtil,0,0,0,0,0,0
System.Web.Razor.Parser,SyntaxConstants,0,0,0,0,0,0
System.Web.Razor.Parser,SyntaxConstants.CSharp,0,0,0,0,0,0
System.Web.Razor.Parser,SyntaxConstants.VB,0,0,0,0,0,0
System.Web.Razor.Parser.SyntaxTree,SyntaxTreeNode,0,0,0,0,0,0
System.Web.Http.Tracing,SystemDiagnosticsTraceWriter,0,0,0,0,0,0
System.Web.Mvc,TagBuilder.Html401IdUtil,0,0,0,0,0,0
System.Web.Mvc,TagBuilderExtensions,0,0,0,0,0,0
System.Web.Mvc,TagRenderMode,0,0,0,0,0,0
System.Threading.Tasks,TaskHelpers.AsyncVoid,0,0,0,0,0,0
System.Threading.Tasks,TaskHelpers.CancelCache<TResult>,0,0,0,0,0,0
System.Web.Http.WebHost,TaskWrapperAsyncResult,0,0,0,0,0,0
System.Web.Mvc,TempDataDictionary.TempDataDictionaryEnumerator,0,0,0,0,0,0
Microsoft.Web.Mvc,TempDataValueProviderFactory,0,0,0,0,0,0
Microsoft.Web.Mvc,TempDataValueProviderFactory.TempDataValueProvider,0,0,0,0,0,0
Microsoft.Web.Mvc,TempDataValueProviderFactory.TempDataVoid,0,0,0,0,0,0
System.Web.Razor.Generator,TemplateBlockCodeGenerator,0,0,0,0,0,0
System.Web.WebPages,TemplateFileInfo,0,0,0,0,0,0
System.Web.Mvc.Html,TemplateHelpers.ActionCacheCodeItem,0,0,0,0,0,0
System.Web.Mvc.Html,TemplateHelpers.ActionCacheItem,0,0,0,0,0,0
System.Web.Mvc.Html,TemplateHelpers.ActionCacheViewItem,0,0,0,0,0,0
System.Web.Mvc.Html,TemplateHelpers.ExecuteTemplateDelegate,0,0,0,0,0,0
System.Web.Mvc.Html,TemplateHelpers.GetDefaultActionsDelegate,0,0,0,0,0,0
System.Web.Mvc.Html,TemplateHelpers.GetViewNamesDelegate,0,0,0,0,0,0
System.Web.Mvc.Html,TemplateHelpers.TemplateHelperDelegate,0,0,0,0,0,0
System.Web.Mvc.Html,TemplateHelpers.ViewDataContainer,0,0,0,0,0,0
System.Web.Mvc,TemplateInfo,0,0,0,0,0,0
System.Web.WebPages,TemplateStack,0,0,0,0,0,0
System.Web.Mvc.Html,TextAreaExtensions,0,0,0,0,0,0
System.Web.Razor.Text,TextBufferReader.BacktrackContext,0,0,0,0,0,0
System.Web.Razor.Text,TextChangeType,0,0,0,0,0,0
System.Web.Razor.Text,TextDocumentReader,0,0,0,0,0,0
System.Web.Razor.Text,TextExtensions,0,0,0,0,0,0
System.Web.Razor.Parser,TextReaderExtensions,0,0,0,0,0,0
ROOT_PROJECT_NAMESPACE.Areas.HelpPage,TextSample,0,0,0,0,0,0
Microsoft.Web.Helpers,Themes,0,0,0,0,0,0
Microsoft.Web.Helpers,ThemesImplementation,0,0,0,0,0,0
System.Web.Razor.Tokenizer,"TokenizerView<TTokenizer, TSymbol, TSymbolType>",0,0,0,0,0,0
System.Web.Helpers.AntiXsrf,TokenValidator,0,0,0,0,0,0
System.Web.Http.Tracing,TraceCategories,0,0,0,0,0,0
System.Web.Http.Tracing,TraceKind,0,0,0,0,0,0
System.Web.Http.Tracing,TraceKindHelper,0,0,0,0,0,0
System.Web.Http.Tracing,TraceLevel,0,0,0,0,0,0
System.Web.Http.Tracing,TraceLevelHelper,0,0,0,0,0,0
System.Web.Http.Tracing,TraceManager,0,0,0,0,0,0
System.Web.Http.SelfHost.ServiceModel,TransferModeHelper,0,0,0,0,0,0
System.Web.Http.SelfHost.ServiceModel.Channels,TransportDefaults,0,0,0,0,0,0
System.Web.Mvc.Async,Trigger,0,0,0,0,0,0
System.Web.Mvc.Async,TriggerListener,0,0,0,0,0,0
System.Web.Mvc,TryGetValueDelegate,0,0,0,0,0,0
System.Web.Http.Internal,TypeActivator,0,0,0,0,0,0
Microsoft.Web.Mvc.ExpressionUtil,TypeBinaryExpressionFingerprint,0,0,0,0,0,0
System.Web.Mvc,TypeCacheSerializer,0,0,0,0,0,0
System.Web.Mvc,TypeCacheUtil,0,0,0,0,0,0
Microsoft.Web.Mvc.ModelBinding,TypeConverterModelBinder,0,0,0,0,0,0
Microsoft.Web.Mvc.ModelBinding,TypeConverterModelBinderProvider,0,0,0,0,0,0
Microsoft.Web.Mvc,TypeDescriptorHelper,0,0,0,0,0,0
Microsoft.Web.Mvc,TypeDescriptorHelper.MockMetadataProvider,0,0,0,0,0,0
System.Net.Http,TypeExtensions,0,0,0,0,0,0
System.Web.Http.Internal,TypeHelper,0,0,0,0,0,0
Microsoft.Web.Mvc.ModelBinding,TypeMatchModelBinder,0,0,0,0,0,0
Microsoft.Web.Mvc.ModelBinding,TypeMatchModelBinderProvider,0,0,0,0,0,0
System.Web.Razor.Generator,TypeMemberCodeGenerator,0,0,0,0,0,0
Microsoft.Web.Mvc.ExpressionUtil,UnaryExpressionFingerprint,0,0,0,0,0,0
System.Web.Http.Results,UnauthorizedResult,0,0,0,0,0,0
System.Web.Mvc,UnobtrusiveValidationAttributesGenerator,0,0,0,0,0,0
System.Net.Http,UnsupportedMediaTypeException,0,0,0,0,0,0
System.Web.Helpers,UnvalidatedRequestValues,0,0,0,0,0,0
System.Web.Mvc,UnvalidatedRequestValuesAccessor,0,0,0,0,0,0
System.Web.Mvc,UnvalidatedRequestValuesWrapper,0,0,0,0,0,0
System.Net.Http,UriExtensions,0,0,0,0,0,0
Microsoft.Web.Mvc.Resources,UriHelperExtensions,0,0,0,0,0,0
System.Net.Http.Formatting,UriPathExtensionMapping,0,0,0,0,0,0
System.Web.Http,UriQueryUtility.UrlDecoder,0,0,0,0,0,0
Microsoft.Web.Helpers,UrlBuilder,0,0,0,0,0,0
System.Web.WebPages,UrlDataList,0,0,0,0,0,0
System.Web.Mvc,UrlParameter,0,0,0,0,0,0
System.Web.WebPages,UrlRewriterHelper,0,0,0,0,0,0
System.Web.WebPages,UrlUtil,0,0,0,0,0,0
System.Web.Http.Validation.Validators,ValidatableObjectAdapter,0,0,0,0,0,0
System.Web.Mvc,ValidateAntiForgeryTokenAttribute,0,0,0,0,0,0
System.Web.Mvc,ValidateInputAttribute,0,0,0,0,0,0
System.Web.Helpers,Validation,0,0,0,0,0,0
System.Web.WebPages,ValidationAttributeAdapter,0,0,0,0,0,0
System.Web.WebPages,Validator,0,0,0,0,0,0
System.Web.Mvc.Html,ValueExtensions,0,0,0,0,0,0
System.Web.Mvc,ValueProviderCollection,0,0,0,0,0,0
System.Web.Mvc,ValueProviderFactories,0,0,0,0,0,0
System.Web.Http.ValueProviders,ValueProviderFactory,0,0,0,0,0,0
System.Web.Mvc,ValueProviderFactoryCollection,0,0,0,0,0,0
Microsoft.Web.Mvc,ValueProviderUtil,0,0,0,0,0,0
System.Web.Http.Controllers,ValueResultConverter<T>,0,0,0,0,0,0
System.Web.Razor.Generator,VBCodeWriter,0,0,0,0,0,0
System.Web.Razor.Tokenizer,VBHelpers,0,0,0,0,0,0
System.Web.Razor.Tokenizer.Symbols,VBKeyword,0,0,0,0,0,0
System.Web.Razor.Tokenizer,VBKeywordDetector,0,0,0,0,0,0
System.Web.Razor.Parser,VBLanguageCharacteristics,0,0,0,0,0,0
System.Web.Razor.Generator,VBRazorCodeGenerator,0,0,0,0,0,0
System.Web.Razor,VBRazorCodeLanguage,0,0,0,0,0,0
System.Web.Razor.Tokenizer.Symbols,VBSymbol,0,0,0,0,0,0
System.Web.Razor.Tokenizer.Symbols,VBSymbolType,0,0,0,0,0,0
System.Web.Mvc,ViewContext.ScopeCache,0,0,0,0,0,0
System.Web.Mvc,ViewDataDictionary.ViewDataEvaluator,0,0,0,0,0,0
System.Web.Mvc,ViewDataDictionary.ViewDataEvaluator.ExpressionPair,0,0,0,0,0,0
System.Web.Mvc,ViewDataDictionary<TModel>,0,0,0,0,0,0
System.Web.Mvc,ViewDataInfo,0,0,0,0,0,0
System.Web.Mvc,ViewEngineCollection,0,0,0,0,0,0
System.Web.Mvc,ViewEngineResult,0,0,0,0,0,0
System.Web.Mvc,ViewEngines,0,0,0,0,0,0
Microsoft.Web.Mvc,ViewExtensions,0,0,0,0,0,0
System.Web.Mvc,ViewPage.SwitchWriter.WriterScope,0,0,0,0,0,0
System.Web.Mvc,ViewResult,0,0,0,0,0,0
System.Web.Mvc,ViewResultBase,0,0,0,0,0,0
System.Web.Mvc,ViewType,0,0,0,0,0,0
System.Web.Mvc,ViewTypeControlBuilder,0,0,0,0,0,0
System.Web.Mvc,ViewTypeParserFilter,0,0,0,0,0,0
System.Web.WebPages,VirtualPathFactoryExtensions,0,0,0,0,0,0
System.Web.WebPages,VirtualPathFactoryManager,0,0,0,0,0,0
System.Web.Mvc,VirtualPathProviderViewEngine.AreaAwareViewLocation,0,0,0,0,0,0
System.Web.Mvc,VirtualPathProviderViewEngine.ViewLocation,0,0,0,0,0,0
System.Web.Helpers,VirtualPathUtil,0,0,0,0,0,0
Microsoft.Web.Helpers,VirtualPathUtilityBase,0,0,0,0,0,0
Microsoft.Web.Helpers,VirtualPathUtilityWrapper,0,0,0,0,0,0
System.Web.Http.Controllers,VoidResultConverter,0,0,0,0,0,0
Owin,WebApiAppBuilderExtensions,0,0,0,0,0,0
System.Web.Helpers,WebCache,0,0,0,0,0,0
System.Web.WebPages.Razor,WebCodeRazorHost,0,0,0,0,0,0
System.Web.WebPages.Scope,WebConfigScopeDictionary,0,0,0,0,0,0
System.Web.Mvc,WebFormView,0,0,0,0,0,0
System.Web.Mvc,WebFormViewEngine,0,0,0,0,0,0
System.Web.Helpers,WebGridColumn,0,0,0,0,0,0
System.Web.Helpers,WebGridPagerModes,0,0,0,0,0,0
System.Web.Helpers,WebGridRow,0,0,0,0,0,0
System.Web.Http.WebHost,WebHostAssembliesResolver,0,0,0,0,0,0
System.Web.Http.WebHost,WebHostBufferPolicySelector,0,0,0,0,0,0
System.Web.Http.WebHost,WebHostExceptionCatchBlocks,0,0,0,0,0,0
System.Web.Http.WebHost,WebHostExceptionHandler,0,0,0,0,0,0
System.Web.Http.WebHost,WebHostHttpControllerTypeResolver,0,0,0,0,0,0
System.Web.Http.WebHost,WebHostHttpRequestContext,0,0,0,0,0,0
System.Web.Helpers,WebImage.CropTransformation,0,0,0,0,0,0
System.Web.Helpers,WebImage.ImageTransformation,0,0,0,0,0,0
System.Web.Helpers,WebImage.ResizeTransformation,0,0,0,0,0,0
System.Web.Helpers,WebImage.RotateTransformation,0,0,0,0,0,0
System.Web.Helpers,WebImage.WatermarkImageTransformation,0,0,0,0,0,0
System.Web.Helpers,WebImage.WatermarkTextTransformation,0,0,0,0,0,0
System.Web.Helpers,WebImage.WatermarkTransformation,0,0,0,0,0,0
System.Web.WebPages.Administration.PackageManager,WebPackageSource,0,0,0,0,0,0
System.Web.WebPages,WebPageHttpModule,0,0,0,0,0,0
System.Web.WebPages,WebPageMatch,0,0,0,0,0,0
System.Web.WebPages,WebPageRoute,0,0,0,0,0,0
Microsoft.Web.WebPages.OAuth,WebPagesOAuthDataProvider,0,0,0,0,0,0
Microsoft.Web.WebPages.OAuth,WebPagesOAuthTokenManager,0,0,0,0,0,0
System.Web.WebPages.Administration.PackageManager,WebProjectManager.ErrorLogger,0,0,0,0,0,0
System.Web.WebPages.Administration.PackageManager,WebProjectSystem,0,0,0,0,0,0
System.Web.Razor.Parser,WhiteSpaceRewriter,0,0,0,0,0,0
ROOT_PROJECT_NAMESPACE.Areas.HelpPage,XmlDocumentationProvider,0,0,0,0,0,0
Microsoft.Web.Mvc.Resources,XmlFormatHandler,0,0,0,0,0,0
System.Web.Razor.Tokenizer,XmlHelpers,0,0,0,0,0,0
System.Net.Http.Formatting,XmlHttpRequestHeaderMapping,0,0,0,0,0,0
System.Web.Http.Tracing.Tracers,XmlMediaTypeFormatterTracer,0,0,0,0,0,0
